COL name VAL loraal paris infaillible 24h fondaten 300 amber	COL name VAL loraal paris infaillible 24h matte cover ya14ksek kapataca fondaten 314 rose porcelain	0
COL name VAL loreal paris micellar makyaj temizleme suyu normalden ve karmaya hassas ciltler icin 200 ml	COL name VAL loreal parismicellar makyaj temizleme suyu normalden ve karmaya hassas ciltler icin 200 ml	1
COL name VAL loreal paris pink dream color riche lipstick 330 cocorico 	COL name VAL loreal paris bambi eye ceylan gaz etkili siyah maskara 	0
COL name VAL 2step saat kalici likit ruj infaillible	COL name VAL loreal paris infaillible 2step 24 saat kalici likit ruj and balm 506 red infaillible	1
COL name VAL loreal paris ruj infallible sexy balm 103 as if	COL name VAL loreal paris infaillible sexy balm ruj 103 as if	1
COL name VAL loraal paris uncensored color riche collection privee freidaatms pomelo skin	COL name VAL loraal paris color riche plump and shine ruj 109 blue mint plump	0
COL name VAL loreal paris infaillible 24h raizin wear pudra fondaten 220 canli mavi	COL name VAL loreal infallible longwear shaping stick 502	0
COL name VAL loreal paris rimel volume million lashes cannes ozel tasarim siyah	COL name VAL loreal paris volume million lashes maskara cannes koleksiyonu ozel tasarim	1
COL name VAL loreal paris color riche free the nudes ruj no doubts	COL name VAL loreal paris ruj color riche free the nudes 03 no doubts	1
COL name VAL loreal paris loreal paris color riche free the nudes ruj no cliche	COL name VAL loreal paris loreal infaillible 110 rose vanilla kalem seti	0
COL name VAL loraal paris infaillible siyah kirmizi max gokyuzumavisi 006 disturbia	COL name VAL loreal paris accord parfait pdre fr 65d65w c	0
COL name VAL loreal color matte addiction ruj 241 a porter	COL name VAL loreal paris color riche matte addiction ruj 241 pink a porter	1
COL name VAL loreal paris mega gloss lip gloss 407 smoke me up	COL name VAL loreal paris ruj infallible mega gloss 407 smoke me up	1
COL name VAL loreal paris x isabel marant lipstick limited edition 01	COL name VAL loreal paris loraal paris infaillible 328 fresh wear c vitaminli fondaten 145 sand	0
COL name VAL loraal paris infaillible ta14m ya14ze uygulanabilir kapataca 334 walnut	COL name VAL loreal paris color riche les nus ruj 138 decadent	0
COL name VAL loreal paris aydinlatici pudra true match highlight powder 102d102w golden glow	COL name VAL loreal paris true match highlight aydinlatici pudra 102d102w golden glow	1
COL name VAL loreal paris color riche rock woman mat ruj 901 rebellion	COL name VAL loreal paris color riche x balmain collection rock woman mat ruj 901 rebellion	1
COL name VAL loraal paris infaillible palealmond lip paint 306 lolita	COL name VAL loreal paris telescopic carbon black maskara siyah	0
COL name VAL loreal paris uzun sure kalici fondoten infallible 24h foundation 235 honey 30 ml	COL name VAL botanicals loreal infallible shaping stick 501	0
COL name VAL loreal paris color riche free the nudes ruj no doubts	COL name VAL paris micellar kusursuz makyaj temizleme suyu ml	0
COL name VAL loreal paris stick allak infaillible shaping stick allak 001 sexy flush 	COL name VAL loreal paris suya dayanakla siyah eyeliner super liner black lacquer waterproof eyeliner 322 ml 	0
COL name VAL loreal paris color riche matte addiction ruj 241 pink a porter	COL name VAL loreal paris color riche matte addiction 241 porter	1
COL name VAL paris shaper kalemi brunette	COL name VAL loreal paris brow artist shaper kas kalemi 03 brunette	1
COL name VAL loreal paris of nu andamp	COL name VAL loreal paris emotions of nu allik andamp far paleti	1
COL name VAL loreal paris colorista washout redhair	COL name VAL loreal paris pudra infallible powder 245 warm sand	1
COL name VAL loreal paris rouge signature empowereds likit mat ruj 136 armored	COL name VAL loreal paris rouge signature empowereds likit mat ruj 136 armored	1
COL name VAL loraal paris true match pudra 3r3c nude beige npalepink	COL name VAL loreal paris rouge signature likit mat ruj 115 i am worth it	0
COL name VAL loreal paris true match bakam yapan fondaten 2d golden almond	COL name VAL loraal paris infaillible shaping stick allak 407 nude an rose	0
COL name VAL loreal paris ruj color riche free the nudes 09 no judgment	COL name VAL loreal paris loreal color queen tekli gaz fara 12 queen	0
COL name VAL loreal paris visible lift serum inside mat 100	COL name VAL loreal paris fondoten no 130 visible lift	1
COL name VAL loreal paris tekli gaz fara color rose vanilla mono eyeshadow 02 sutlupembe 	COL name VAL loreal paris loraal paris paradise suya dayanakla siyah maskara	0
COL name VAL loreal paris infaillible 24h matte cover yuksek kapatici fondoten 130 true beige	COL name VAL infaillible matte yuksek 130	1
COL name VAL loreal paris ruj color riche free the nudes 09 no judgment	COL name VAL loreal paris color riche free the nudes ruj no judgment	1
COL name VAL loreal paris ruj color riche privee nudes juliannes nude	COL name VAL paris color riche privee nudes juliannes	1
COL name VAL loreal paris mat ruj color riche matte addiction 652 stone 	COL name VAL loreal paris kaay kalemi brow artist high contour 102 cool brown 	0
COL name VAL loreal paris mat ruj color riche matte addiction lipstick 430 mon jules	COL name VAL loreal paris color riche matte addiction ruj 430 mon jules bordo	1
COL name VAL loraal paris infaillible electric ruby lip paint 306 lolita	COL name VAL loraal paris true match bakam yapan fondaten 45n true beage	0
COL name VAL loraal paris infaillible ta14m ya14ze uygulanabilir kapataca 330 pecan	COL name VAL loreal paris color riche safari woman mat ruj 501 glamazone	0
COL name VAL loreal paris infaillible 24h fondoten 120 vanilla	COL name VAL loreal paris loreal paris infaillible 32h fresh wear c vitaminli fondoten 120 golden vanilla	1
COL name VAL loreal paris color queen tekli goz fari 29 ruthless	COL name VAL loreal color queen tekli goz fari 29 ruthless	1
COL name VAL loreal paris matlaaytaraca ndramaticred baza infaillible mattifying slayinrose 	COL name VAL loreal expert loreal paris infaillible 24h fondaten 200 golden sand	0
COL name VAL loreal paris manga mor maskara tropical violet	COL name VAL loreal paris loreal paris manga mor maskara tropical violet	1
COL name VAL loreal paris goz fari infaillible paint nude eyeshadow 205 champagne	COL name VAL loreal paris infaillible nudist eye paint 205cocky bisque	1
COL name VAL loreal paris brilliant signature plump in gloss ruj 410 i inflate	COL name VAL loreal paris brilliant signature plump in gloss ruj 410 i inflate	1
COL name VAL loreal paris 302rc true match highlight aydinlatici pudra	COL name VAL loreal paris true match 21 vurgu bazli pudra parlatici highlight 302r302c 9g ozel koleksiyon	1
COL name VAL loraal paris smokey grey tn bronzlaaytaraca pudra 04 taormina intenso	COL name VAL loreal paris loreal micellar makyaj temizleyici paradise intense maskara seti	0
COL name VAL loreal paris likit delight verylight cift altin signature110 kahvealtinsimli 	COL name VAL loreal paris aa etkili macellar makyaj temizleme suyu normal karma ciltler 200 ml	0
COL name VAL loreal paris infaillible 24h fresh wear 140 beige dore kajal goz kalemi	COL name VAL loreal paris infaillible 24h fresh wear 140 beige dorekajal goz kalemi	1
COL name VAL loraal paris rouge signature likit mat ruj 114 i represent	COL name VAL loreal paris true match bakam yapan fondaten 915 linen	0
COL name VAL loreal paris ruj color riche collection privee doutzens nude	COL name VAL loreal paris le linersignature gold sara gaz kalemi 358	0
COL name VAL paris paris crayon golden	COL name VAL loreal paris paris waterproof crayon eyeliner 06 golden	1
COL name VAL loreal paris uzun sa14re kalaca fondaten infallible 24h foundation 150 beige 30 ml 	COL name VAL loraal paris rouge signature likit mat ruj 5 i savor	0
COL name VAL loreal paris goz kalemi no 107 kot mavisi	COL name VAL loreal paris lacivert goz kalemi contour khol kajal 138 blue denim	1
COL name VAL loraal paris telescopic maskara siyah 2li	COL name VAL loreal paris ruj color riche free the nudes 860 no obstacles 	0
COL name VAL loreal paris infaillible ta14m ya14ze uygulanabilir kapataca 327 cashmere	COL name VAL loreal paris true match foundation 135 linen fondaten 	0
COL name VAL loreal paris kapatici true match concealer 2rc rose vanilla	COL name VAL loreal paris kapatici	1
COL name VAL loreal paris loraal paris true match bakam yapan fondaten 7d golden amber	COL name VAL loreal paris eyeliner merry metals superliner 213 gold 	0
COL name VAL paris unbelieva brow uzun sure seffaf kas maskarasi	COL name VAL loreal paris unbelieva brow uzun sure kalici seffaf kas maskarasi	1
COL name VAL loreal paris infaillible 32h fresh wear c vitaminli fondoten 60 rose ivory	COL name VAL loreal paris loreal color riche plump and shine ruj	0
COL name VAL loreal paris cest magic kizariklik giderici cc krem	COL name VAL loreal paris cest magic cc krem 1 anti redness skin enhancer	1
COL name VAL loreal paris true match bakim yapan fondoten 2r rose vanilla	COL name VAL loreal paris bakim yapan rose vanilla	1
COL name VAL loraal paris infaillible 24h fondaten 130 true kiss to say	COL name VAL loreal paris emotions of nu allak and far paleti emotaons nude	0
COL name VAL loreal paris unlimited siyah maskara garnier micellar temsuyu	COL name VAL loreal paris tekli gaz fara color queen mono eyeshadow 181 commander 	0
COL name VAL loreal paris pudra true match powder n4 beige 	COL name VAL loraal paris colour riche extraordinaire ruj 55d rose finale	0
COL name VAL loreal paris rouge signature likit mat ruj 105 i rule	COL name VAL loreal paris rouge signature matte likit ruj 105 rule	1
COL name VAL loreal paris glow mon amour likit aydinlatici 02 bellini	COL name VAL loreal paris loreal paris glow mon amour likit aydinlatici 02 loving peach	1
COL name VAL loreal paris kaay kalemi brow artist high contour 107 cool brown 	COL name VAL loraal paris les chocolats likit mat ruj 05r dose of cocoa	0
COL name VAL loreal paris brow artist xpert no 106 grey brunette	COL name VAL loreal paris kas kalemi brow artist xpert 106 grey brune	1
COL name VAL loraal paris rouge signature likit mat ruj 112 i achieve	COL name VAL loreal paris tekli gaz fara color queen mono eyeshadow 1000 determination 	0
COL name VAL loreal paris superliner smokissime eyeliner	COL name VAL loreal paris siyah eyeliner smokissime superliner 100 black	1
COL name VAL loreal paris in the shadows pudra infaillible 24h ultra m tangerine crush prestige pudra 225 biscuitandcoral 	COL name VAL loreal paris siyah maskara bambi eye oversized black	0
COL name VAL loreal paris loreal paris micellar makyaj temizleme suyu normalden kuruya hassas ciltler icin 200 ml	COL name VAL paris micellar makyaj temizleme suyu kuruya ciltler 200	1
COL name VAL loreal paris loreal true match rollon fondoten n4	COL name VAL loreal paris true match roller n4 buff beige	1
COL name VAL loreal paris suya dayanakla siyah eyeliner super liner black lacquer waterproof eyeliner 6 ml 	COL name VAL loraal paris infaillible 24h fondaten 212 natural rose	0
COL name VAL loreal paris kahverengi kas kalemi brow artist designer eyebrow pencil 302 golden brown	COL name VAL loreal paris color riche le sourcil kas kalemi 302 golden brown	1
COL name VAL loreal paris likit mat ruj rouge signature 103 enjoy 	COL name VAL loreal paris bb krem bonjour nudista bb cream 176 medium dark 	0
COL name VAL loreal paris bb krem orta ton skin perfection bb cream medium spf 25 50 ml	COL name VAL loreal paris skin perfection cilt kusursuzlastirici 5i 1 arada bb krem orta ton	1
COL name VAL loreal paris infaillible magic essence drops likit makyaj bazi	COL name VAL loreal paris likit makyaj bazi infaillible magic essence drops	1
COL name VAL loreal paris infaillible eye paint gaz fara 102 intense green	COL name VAL loraal paris infaillible 24h concealer pomade kapataca 02 medium koyu ton	0
COL name VAL loreal volume million lashes mascara fatale black	COL name VAL loraal paris brow artist skinny definer kaay kalemi 412 chatain	0
COL name VAL loreal paris koyukahverengi les chocolats ultra golden hour liquid lipstick 860 likit light sand metallic cherry	COL name VAL loraal paris infaillible ta14m ya14ze uygulanabilir kapataca 323 fawn	0
COL name VAL loreal paris dudak kalemi infaillible lip pencil 105 red fiction	COL name VAL loreal paris infaillible dudak kalemi 105 red fiction kirmizi	1
COL name VAL loreal paris glow dreamcatcher antique rouge balm in lipstick 244 neutral sand n decadent kayasa  244	COL name VAL loreal paris infaillible 24h matte cover ya14ksek kapataca fondaten 155 natural rose	0
COL name VAL loraal paris color riche deep with warm neutral addiction glam 908 double shot grilila	COL name VAL loreal paris loraal paris color riche plump and shine ruj	0
COL name VAL loreal paris volume million lashes mascara black	COL name VAL loraal paris true match allak 204 sandalwood pink	0
COL name VAL loraal paris les macarons likit blushed nude matkahve 820 hafifgumussimli kivirengi paris	COL name VAL loreal paris gaz fara quads4 tropicaltutu 	0
COL name VAL loreal paris ruj color riche lipstick 134 pink panac	COL name VAL loreal paris color riche ruj 134 pink panac	1
COL name VAL loraal paris wn ecru bonny cushion fondaten 11 vanity fair neonfuchsia sedefli	COL name VAL loraal paris true match bakam yapan fondaten 45n true beage	0
COL name VAL loreal paris color riche shine ruj 470 map to nirvana mor	COL name VAL loreal paris color riche shine addiction lipstick 470 map to nirvana ruj	1
COL name VAL loreal paris color riche dudak kalemi 461 scarlet rouge	COL name VAL loreal paris dudak kalemi color riche crayon liner 461 scarlet rouge	1
COL name VAL loraal paris infaillible gel crayon gaz kalemi 13 uptown p ghs koyu murdum	COL name VAL loraal paris infaillible 24h matte cover ya14ksek kapataca fondaten 115 golden beige	0
COL name VAL loreal paris goz fari paleti la petite palette nudist	COL name VAL bakim yapan fondoten golden	0
COL name VAL loreal paris color riche les nus ruj 182 nu extreme	COL name VAL loreal color nus ruj 182 nu	1
COL name VAL loraal paris superliner smokissime eyeliner nocolor fdbbd	COL name VAL loreal paris aydanlak veren renkli nemlendirici glow cherie light glow 	0
COL name VAL loreal paris kas kalemi brow artist xpert 108 warm brune	COL name VAL loreal paris brow artist xpert no 108 warm brunette	1
COL name VAL loreal paris infaillible 24h matte cover yuksek kapatici fondoten 320 toffee	COL name VAL loreal paris infaillible 24h matte cover yuksek kapatici fondoten 320 toffee	1
COL name VAL loreal paris loreal true match foundation 5d golden sand fondoten sungeri seti	COL name VAL true match foundation golden	1
COL name VAL loreal paris mat ruj color riche matte addiction lipstick 636 mahogandy studs	COL name VAL loreal paris color riche matte addiction ruj 636 mahogany studs kahverengi	1
COL name VAL loreal paris loreal paras infallable 145 beige rose 	COL name VAL loraal paris true match bakam yapan fondaten 129lead golden ivory	0
COL name VAL loreal paris brow artist skinny definer kaay kalemi 104 chatain 	COL name VAL loreal paris color riche ruj matte addiction 314 coral style	0
COL name VAL loreal paris gaz fara infallible eyeshadow paint 302 damla uc kirmizi mm w light medium 	COL name VAL loreal paris gaz fara infallible eyeshadow paint 201 golden eye 	0
COL name VAL loreal paris true match bakim yapan fondoten 65d golden toffee	COL name VAL true bakim fondoten 65d golden toffee	1
COL name VAL loreal paris color riche matte addiction ruj 103 blush in a rush pembe	COL name VAL loreal paris mat ruj color riche matte addiction lipstick 103 rose clutch	1
COL name VAL loreal paris brow artist skinny definer kaay kalemi 105 brunette 	COL name VAL loreal paris micellar makyaj temizleme suyu normalden ve kuruya hassas ciltler iain 60 ml	0
COL name VAL loreal paris les macarons likit mat ruj 832 strawberry sauvage	COL name VAL loreal paris les macarons ultra matte likit ruj 832 strawberry	1
COL name VAL loreal paris true match allik 90 luminous rose	COL name VAL loreal paris allik true match le blush no 90 luminous rose	1
COL name VAL loreal paris lip paint likit ruj matte purple	COL name VAL loreal paris infaillible lip paint likit ruj matte 207 wuthering purple	1
COL name VAL loraal paris color queen tekli gaz fara 16 determination	COL name VAL loreal paris likit mat ruj rouge signature 50ml i dont	0
COL name VAL loreal paris stick aydanlataca infaillible shaping stick 502 en acik is steel gray 	COL name VAL loraal paris color riche plump and shine ruj 101 nectarine plump	0
COL name VAL loreal paris paradise siyah maskara	COL name VAL loreal paris loreal paris paradise siyah maskara	1
COL name VAL loreal paris maskara ekstra volume collagene 1000 lashes	COL name VAL loreal paris volume million lashes mascara siyah	1
COL name VAL loreal paris unlimited siyah maskara 2li set ayna	COL name VAL loreal paris ruj infallible mega gloss 908 smoke me up 	0
COL name VAL loreal paris true match pudra 4n beige	COL name VAL loreal paris pudra true match powder 2r2c rose vanilla	1
COL name VAL loreal paris cr ultra matte ruj no 01 obstacle	COL name VAL loreal paris paris amber	0
COL name VAL loraal paris les macarons likit metalikbronz forever nude 818 dose of tenrengikod	COL name VAL loraal paris les chocolats likit mat ruj 868 cacao rush	0
COL name VAL loreal paris unlimited siyah maskara 2li set	COL name VAL loreal paris ruj color riche free the nudes 130 no diktat	0
COL name VAL loraal paris color riche saten bitiayliruj 125 maison marais karmaza	COL name VAL loraal paris les chocolats likit mat ruj 00 tasty ruby	0
COL name VAL loraal paris infaillible 24h fondaten 125 rich amber maroonsix	COL name VAL loraal paris mega gloss lip gloss 206 for the ladies	0
COL name VAL loreal paris million lashes mascara extra black siyah maskara 	COL name VAL loreal paris true match gaz kremi iaeren kapataca 111 05r ivory beige	0
COL name VAL loreal paris telescopic daydreaming bodrum maskara fc new rock maskara	COL name VAL loraal paris matte signature eyeliner 03 marron kahverengi	0
COL name VAL loreal paris mat gri superliner superliner mat matic 03 taupe grey	COL name VAL loreal paris super liner gelmatic 03 taupe grey gri goz kalemi	1
COL name VAL loreal paris volume million lashes mascara beyaz kalin	COL name VAL loreal paris color riche saten bitiayli ruj 107 seine sunset nude	0
COL name VAL loreal paris unlimited siyah maskara	COL name VAL loreal paris unlimited maskara siyah	1
COL name VAL paris mat ruj rouge signature 112 achieve	COL name VAL loreal paris likit mat ruj rouge signature 112 i achieve	1
COL name VAL loreal paris infaillible 24h fresh wear fondaten 120 vanilla 30ml	COL name VAL loreal paris kaay kalemi brow artist xpert 109 warm brune 	0
COL name VAL loreal paris infaillible 2step 24 saat kalici likit ruj and balm 506 red infaillible	COL name VAL loreal paris infaillible 24h ruj 506 red infaillible	1
COL name VAL loreal paris infaillible 24h goz kalemi 314 forever blue	COL name VAL loreal paris mavi eyeliner infallible stylo eyeliner 24h 314 forever blue	1
COL name VAL loreal paris color riche x balmain ruj 902 legend kahverengi	COL name VAL loreal paris infaillible eye paint gaz fara 401 irresistible	0
COL name VAL loreal paris true match bakam yapan fondaten 1n ivory	COL name VAL loreal paris bb krem bonjour nudista bb cream 2n medium dark 	0
COL name VAL loreal paris rouge signature likit mat ruj	COL name VAL loreal paris likit mat ruj les macarons ultra matte liquid lipstick 7r infinite spice 	0
COL name VAL loreal paris loreal infaillible more than concealer kapataca 323 brickthrough	COL name VAL loreal paris lash sensational yelpaze etkili maskara burgundy brown	0
COL name VAL loreal paris aydanlataca palet en glow warm glow faraa seti	COL name VAL loreal paris kapataca true match concealer 9g vanilla 	0
COL name VAL loreal paris color riche free the nudes ruj no pressure	COL name VAL paris color free the nudes ruj no pressure	1
COL name VAL loreal paris ruj color riche free the nudes 05 no diktat	COL name VAL paris color naked tans 659 blow glow nude	0
COL name VAL loreal paris color riche matte addiction ruj 463 plum tuxedo	COL name VAL loreal paris ruj color riche matte addiction lipstick 463 plum tuxedo	1
COL name VAL loreal paris infaillible gozenek gizleyici makyaj bazi	COL name VAL loreal paris infaillible gozenek gizleyici makyaj bazi	1
COL name VAL loraal paris figurlu renkli signature eyeliner 02 be brillant purple dusk sedefli	COL name VAL loreal paris loraal paris true match bakam yapan fondaten 4n beage	0
COL name VAL loreal paris loreal paris telescopic carbon black maskara siyah 8 ml	COL name VAL paris telescopic carbon maskara	1
COL name VAL paris lash intense black siyah	COL name VAL loreal paris loreal paris lash paradise intense black ekstra siyah maskara 1 paket 1 x 23 g	1
COL name VAL loreal paris gaz fara infallible eyeshadow paint 201 nclear eye 	COL name VAL loraal paris true match bakam yapan fondaten 2n vanilla	0
COL name VAL loreal paris rouge signature lip topper dudak parlatici ruj 211 rose gold	COL name VAL loreal paris parlatici ruj rouge signature lip topper 211 rose gold	1
COL name VAL loreal paris les chocolats likit mat ruj 842 candy man	COL name VAL loreal paris likit mat ruj les chocolats ultra matte liquid lipstick 842 candy man	1
COL name VAL loreal paris true match bakam yapan fondaten 45n true beige	COL name VAL loreal paris likit mat ruj les macarons ultra matte liquid lipstick 179 dose of ros	0
COL name VAL loreal paris ral infmacaronsnu ruj 834 infinite sp	COL name VAL loreal paris likit mat ruj les macarons ultra matte liquid lipstick 834 infinite spice	1
COL name VAL loreal paris loreal paris mega volume collagene 24h siyah maskara maskara	COL name VAL loreal paris mega siyah maskara	1
COL name VAL loreal paris goz fari infallible eyeshadow paint 102 irresistible	COL name VAL loreal paris infaillible eye paint goz fari 102 irresistible	1
COL name VAL loreal paris telescopic maskara siyah	COL name VAL loreal paris gaz fara infallible eyeshadow paint 905 irresistible 	0
COL name VAL loraal paris superliner tattoo signature liner ekstra limon sari	COL name VAL loreal paris ruj xmas color riche lipstick lipstick close at night 	0
COL name VAL loreal paris loreal paris true match bakam yapan fondaten 2r rose vanillatrue match kapataca 2rc rose vanilla	COL name VAL loreal paris infaillible matte lip crayon kalem mat ruj 703 caramel rebel	0
COL name VAL loraal paris true match bakam yapan fondaten 65d golden toffee	COL name VAL loraal paris infaillible shaping stick aydanlataca 18 oh my jewels	0
COL name VAL loreal paris tekli gaz fara color queen mono eyeshadow 23 charged 	COL name VAL loraal paris les chocolats likit mat ruj 143 candy man	0
COL name VAL loreal paris bronze bronzlastirici pudra amalfi medio 03	COL name VAL loreal paris bronze please bronzlastirici pudra 03 amalfi medio	1
COL name VAL loreal paris infaillible 24h concealer pomade kapatici 20 peach notr	COL name VAL loreal paris kapatici infaillible 24h concealer pomade 20 peach	1
COL name VAL loreal paris caresse lipstick ruj 202	COL name VAL loreal paris rouge caresse 202 impulsive fuchsia ruj	1
COL name VAL loreal paris mat ruj infallible matte rouge 008 i gotta feeling	COL name VAL loraal paris les macarons likit mat ruj 15n blackcurrant crush	0
COL name VAL loreal paris loraal paris le liner signature waterroof gri gaz kalemi 08 taupe grey tweed	COL name VAL loreal paris pudra true match powder 906 rose beige 	0
COL name VAL loreal paris nocolor dbbe maskara false lash architect 4d mascara softblack 	COL name VAL loreal paris loreal paris infaillible 24h matte cover ya14ksek kapataca fondaten no 300 amber	0
COL name VAL loreal paris ruj color riche rouge caresse lipstick 202 impulsive fuschia	COL name VAL loreal paris caresse lipstick ruj 202	1
COL name VAL loreal paris color richa ultra ravishing red pl pearly amethyst bad reputation tenacik 6 hesitation	COL name VAL loreal paris loraal paris bronze to paradise mat bronzlaaytaraca pudra 02 baby one more tan	0
COL name VAL loraal paris true match bakam yapan fondaten 5d golden sand	COL name VAL loreal paris parlataca ruj rouge signature lip topper 636 rose gold 	0
COL name VAL loreal paris les macarons ultra matte likit ruj 832 strawberry	COL name VAL loreal paris macarons ultra likit ruj 832 strawberry	1
COL name VAL loraal paris infaillible 24h justpeachy cover ya14ksek kapataca fondaten 115 provoking mermer bej altin	COL name VAL loraal paris color riche matte addiction ruj 634 greige perfecto kahverengi	0
COL name VAL loraal paris brow ten high contour 105 jl scarlet glamorous rose	COL name VAL loraal paris true match bakam yapan fondaten 1r rose ivory	0
COL name VAL loreal paris paris mega volume missbaby roll maskara black	COL name VAL loreal paris miss baby roll siyah maskara	1
COL name VAL loreal paris wild sunset kayasa kokulu maskara 	COL name VAL loreal paris loreal paris true match bakam yapan fondaten 4n beige	0
COL name VAL loreal paris gaz fara infallible paint nude eyeshadow peach me babe 	COL name VAL loreal paris ruj color riche lipstick 3r3c cocorico 	0
COL name VAL loreal paris 24 saat kalaca spectrum blue neonlilyumno 300	COL name VAL loraal paris rouge signature empowereds likit mat ruj 142 prepared	0
COL name VAL loraal paris infaillible metallic eye paint 401 metallic copper	COL name VAL loreal paris caresse lipstick ruj 360052	0
COL name VAL loreal paris makyaj fircasiallik fircasi	COL name VAL loreal paris loreal paris makyaj allik fircasi	1
COL name VAL loreal paris ruj color riche shine naked tans 659 blow your glow nude	COL name VAL loreal paris color riche shine naked tans ruj 656 beige in the city nude	1
COL name VAL loreal paris la petite far paleti stylist	COL name VAL loreal paris goz fari paleti la petite palette stylist	1
COL name VAL loreal paris loreal color queen tekli gaz fara 26 stunner	COL name VAL loraal paris les chocolats likit mat ruj 200 sweet tooth	0
COL name VAL loreal paris ruj lip paint metallic 306 lolita 	COL name VAL loraal paris color riche matte addiction ruj 142 moka chic nude	0
COL name VAL loreal paris volume million lashes kadinlar gunu ozel tasarim	COL name VAL loreal paris loreal paris maskara volume million lashes kadinlar gunu ozel tasarim	1
COL name VAL loreal paris likit ruj color riche lextraordinaire lipstick 304 ruby opera	COL name VAL loreal paris extraordinaire 304 ruby opera	1
COL name VAL loreal paris mat ruj color riche matte addiction 654 bronze sautoir	COL name VAL loreal paris color riche matte addiction ruj 654 bronze sautoir kahverengi	1
COL name VAL loreal paris glam shine balmy gloss 915	COL name VAL loreal paris loraal dermo expertise kusursuz mak tem suyu 3d ml normal	0
COL name VAL loraal paris infaillible 24h fondaten 130 true murdumkahve	COL name VAL loreal paris rouge signature likit mat ruj 105 rule	0
COL name VAL loreal paris brow artist high contour 105 brunette kumral	COL name VAL loreal paris fondoten 3 light	0
COL name VAL loreal stick aydinlatici infaillible stick 501 oh my jewels	COL name VAL loreal paris stick aydinlatici infaillible shaping stick 501 oh my jewels	1
COL name VAL loraal paris true match highlight aydanlataca 101d101w cookies cocoa	COL name VAL loreal paris ruj color riche free the nudes 06 no hesitation 	0
COL name VAL loreal paris infaillible 2step 24 saat kalici likit ruj and balm 213 toujours teaberry	COL name VAL loeral infaillable lipstick 2 steps 213 toujours t	1
COL name VAL loreal botanicals loreal infallible longwear shaping stick 501	COL name VAL botanicals loreal infallible shaping stick 501	1
COL name VAL loreal paris infaillible shaping stick fondoten 140 natural rose	COL name VAL loreal paris infaillible shaping stick fondoten 140 natural rose	1
COL name VAL loreal paris true match goz kremi iceren kapatici 12d ivory beige	COL name VAL paris riche 655 copper	0
COL name VAL loraal paris color riche free the sweetandsour lady danger trendsetter obstacles	COL name VAL loreal paris micellar makyaj temizleme suyu normalden ve karmaya hassas ciltler iain	0
COL name VAL loreal paris infaillible 24h matte cover yuksek kapatici fondoten 155 natural rose	COL name VAL loreal paris infaillible 24h matte cover yuksek kapatici fondoten 155 natural rose	1
COL name VAL loreal paris 24 saat kalici kalem no 306 stay blue	COL name VAL 24 kalici no 306	1
COL name VAL loreal paris ruj lip paint metallic 301 pixie 	COL name VAL loreal paris tekli gaz fara color queen mono eyeshadow 908 unsurpassed 	0
COL name VAL loreal paris true match kapatici 01 ivory beige	COL name VAL loreal paris true match kapatici 01 beige	1
COL name VAL loreal paris loraal paris color riche free the nudes ruj no cliche	COL name VAL loreal paris le khol immaculate snow gaz kalemi 247 	0
COL name VAL loraal paris extraordinaire 101 rose melody	COL name VAL loraal paris infaillible 24h fondaten 915 sand	0
COL name VAL loreal paris loraal paris true match bakam yapan fondaten 5d koyu kirmizi uzum waterproff	COL name VAL loreal paris loraal paris telescopic maskara siyah 1 paket	0
COL name VAL loreal paris likit metalik ruj rouge signature metallic 206 i scintillate 	COL name VAL loreal paris color queen tekli gaz fara 110 ruthless	0
COL name VAL loreal paris likit aydanlataca glow mon fire down below droplet highlight 03 enhance in silver lining 	COL name VAL loreal paris loraal paris true match nude fondaten serum 3 4 light medium	0
COL name VAL loreal paris true match kapatici 2rc rose vanilla	COL name VAL loreal paris kapatici true match concealer 2rc rose vanilla	1
COL name VAL loreal paris loraal paris true match nude fondaten serum 3 4 light medium	COL name VAL loraal paris color queen tekli gaz fara 31	0
COL name VAL loreal paris siyah maskara false lash butterfly effect maskara	COL name VAL loreal paris false lash butterfly effect mascara maskara	1
COL name VAL loreal paris infaillible 24h fondoten 150 radiant eclat	COL name VAL loreal paris uzun sure kalici fondoten infallible 24h foundation 150 beige 30 ml	1
COL name VAL loreal paris suya dayanakla tanned camelia eyeliner super liner darkgold lacquer waterproof eyeliner 6 jungle green 	COL name VAL loreal paris gaz fara color riche quad s3 discosmoking 	0
COL name VAL loraal paris telescopic maskara siyah 1 paket	COL name VAL loreal paris infaillible 24h fresh wear pudra fondaten 864 cashmere	0
COL name VAL loraal paris rouge signature lip topper dudak parlataca ruj 210 white gold	COL name VAL loraal paris les chocolats likit mat ruj 135 volupto choco	0
COL name VAL loreal paris loraal paris true match bakam yapan fondaten 5d golden sand	COL name VAL loreal paris color queen tekli gaz fara 2d ruthless	0
COL name VAL loreal paris goz fari infallible eyeshadow paint 303 breathtaking	COL name VAL loreal paris infaillible eye paint goz fari 303 breathtaking brown	1
COL name VAL loreal paris kazaraklak giderici makyaj baza infaillible anti redness primer	COL name VAL loraal paris superstar maskara false lash 328 siyah	0
COL name VAL loreal paris infaillible sangria lip crayon nocolor cbaef pink in summer yogunkahve 108 hot m blue dusk	COL name VAL loreal paris loreal micellar makyaj temizleyici paradise intense maskara seti	0
COL name VAL loreal paris loraal paris true match bakam yapan fondaten 1r rose ivory 30 ml	COL name VAL loreal paris ruj lip paint metallic 7dw lolita	0
COL name VAL loreal paris likit metalik ruj rouge signature metallic 202 i electrify	COL name VAL loreal paris rouge signature metallic likit ruj 202 i electrify	1
COL name VAL loreal paris true match kapataca 7dw bold honey mat antik leylak	COL name VAL loreal paris loraal paris color queen tekli gaz fara 11 worth it	0
COL name VAL loreal paris dudak kalemi color riche crayon liner 302 bois n neutre clair m red sand 	COL name VAL loraal paris superliner smokissime eyeliner black	0
COL name VAL loreal paris kaay kalemi brow koyu tonlar high contour 103 hot in here fcutopiavacation 	COL name VAL loreal paris kaay kalemi brow artist high contour 109 ebony 	0
COL name VAL loreal paris cest magic bb krem 02 light	COL name VAL loreal paris cest magic bb krem 02 light	1
COL name VAL loreal paris infaillible shaping stick fondoten 130 vanilla	COL name VAL loreal paris stick fondoten infaillible shaping stick fondoten 130 vanilla	1
COL name VAL loreal paris true match prestige pudra 3d sweet stash dance with me	COL name VAL loraal paris brow artist high contour 102 cool blond saraayan	0
COL name VAL loreal paris color riche les nus ruj 179 nu decadent	COL name VAL loreal paris bb krem orta ton skin perfection bb cream medium spf 349 213 ml 	0
COL name VAL loreal paris loreal paris glow mon amour likit aydinlatici 02 loving peach	COL name VAL loreal paris glow mon amour likit aydinlatici 02 bellini	1
COL name VAL loreal paris infaillible 24h matte cover yuksek kapatici fondoten 115 golden beige	COL name VAL paris contour khol kalemi 132 metal	0
COL name VAL loraal paris telescopic maskara siyah 2li	COL name VAL loreal paris gri eyeliner infallible gel crayon eyeliner 412 grey 	0
COL name VAL loreal paris loraal paris true match bakam yapan fondaten 15 linen	COL name VAL loraal paris rouge caresse 011 rocknmauve ruj	0
COL name VAL loreal paris siyah eyeliner smokissime superliner 100 black 	COL name VAL loraal paris true match bakam yapan fondaten 112 nut brown	0
COL name VAL loraal paris crosswires signature parisian truebeige likit nudes renkli cold brew 128 i decide	COL name VAL loraal paris infaillible 24h fondaten 230 radiant honey	0
COL name VAL loreal paris ultra matte liquid lipstick les chocolats 856 yum 75ml	COL name VAL ultra matte 856 75ml	1
COL name VAL loreal paris stick aydinlatici infaillible shaping stick 501 oh my jewels	COL name VAL loreal nudista aydinlik veren renkli nemlendirici medium dark koyu ton	0
COL name VAL loreal paris loreal paris mega volume collagene 24h siyah maskara	COL name VAL loreal expert loreal paris mega volume collagene 24h siyah maskara	1
COL name VAL loreal paris caresse rouge 202 impulsive fuschsia	COL name VAL loreal paris ruj color riche rouge caresse lipstick 202 impulsive fuschia	1
COL name VAL loreal paris likit mat ruj infallible lip paint matte 202 king pink	COL name VAL loreal paris likit mat ruj 103	0
COL name VAL loreal paris hdf signature likit sweet sakura kissed bronze 114 i represent	COL name VAL loreal paris loraal paris true match nude fondaten serum 3 4 light medium	0
COL name VAL loreal paris ruj lip paint metallic 306 lolita	COL name VAL loraal paris true match allak 842 luminous rose	0
COL name VAL loinfaillible 24h fresh wear pudra fondoten 120 vanilla	COL name VAL loreal paris infaillible 24h fresh wear pudra fondoten 120 vanilla	1
COL name VAL loreal paris infaillible resurfacing gozenek gizleyici ve puruzsuzlestirici baz	COL name VAL loreal paris infallible mattifying base primer	1
COL name VAL loraal paris true match bakam yapan fondaten 2d golden almond	COL name VAL loraal paris color riche intense volume matte ruj 180 blush audace	0
COL name VAL loreal botanicals loreal paris infallible longwear lip liner 011 violet vava voum	COL name VAL loreal paris true match fondaten 130 vanilla	0
COL name VAL loreal paris karl lagerfeld collection far paleti	COL name VAL loreal paris karl lagerfeld collection far paleti 01	1
COL name VAL loraal paris brow artist paradise kaay pomada 104 brunette kumral	COL name VAL loraal paris rouge caresse ruj 18 cheeky magenta	0
COL name VAL loreal paris rouge likit mat ruj	COL name VAL loreal paris rouge signature likit mat ruj 106 i speak up	1
COL name VAL loreal paris kahverengi les chocolats ultra matte liquid lipstick 860 likit mat ruj	COL name VAL loreal paris les chocolats likit mat ruj 860 ginger bomb	1
COL name VAL loreal paris infaillible 24h fondoten 140 golden beige	COL name VAL loreal infaillible 24h fondoten 140 golden beige	1
COL name VAL loraal paris extraordinaire 304 ruby opera	COL name VAL loreal paris infaillible 24h matte cover ya14ksek kapataca fondaten 290 radiant vanilla 	0
COL name VAL loreal paris likit sari siyah ve kahve radiant les macarons ultra su liquid lipstick 830 blackcurrant juicy yaz 360052	COL name VAL loreal paris loreal ceylan gaz etkili ekstar siyah maskaramaybelline kajal gaz kalemi	0
COL name VAL loreal paris color riche free the nudes ruj no obstacles	COL name VAL loreal paris cr ultra matte ruj no 01 obstacle	1
COL name VAL loraal paris true match bakam yapan fondaten 1d jl world of blues top mavi mm	COL name VAL loraal paris infaillible dudak kalemi 001 higlight on point nude	0
COL name VAL loreal paris likit mat ruj les macarons ultra matte liquid lipstick 830 blackcurrant crush	COL name VAL loreal paris les macarons ultra matte likit ruj 830 blackcurrant	1
COL name VAL loreal paris loreal paris telescopic carbon black maskara siyah and infaillible 24h fresh wear pudra fondaten 120 vanilla	COL name VAL loraal paris true match allak 2 rose pastel	0
COL name VAL loreal paris infaillible eye paint gaz fara 102 irresistible	COL name VAL loraal paris infaillible 24h matte cover ya14ksek kapataca fondaten 238 radiant honey	0
COL name VAL loreal paris volume million lashes balm brown kahverengi maskara 9 ml	COL name VAL loreal balm maskara ml	1
COL name VAL loreal paris maskara volume million lashes extra black	COL name VAL loreal paris volume million lashes carbon black maskara siyah	1
COL name VAL loreal paris true match highlight aydinlatici pudra 102d102w golden glow	COL name VAL paris infaillible 24h matte vanilla kalem seti	0
COL name VAL loreal paris infaillable lipgloss 309 sayonara sunset	COL name VAL loreal paris paris infaillible 24h concealer pomade kapataca 306 medium	0
COL name VAL loraal paris infaillible dudak kalemi 701 stay limon sari acik somon rengi	COL name VAL loreal paris stick aydanlataca infaillible shaping stick 502 gold is cold 	0
COL name VAL loreal paris goz fari paleti la petite palette feminist	COL name VAL loreal paris la petite far paleti feminist	1
COL name VAL loreal paris loreal paris lash paradise siyah maskara maskara	COL name VAL loraal paris glow mon amour likit aydanlataca 129 bronze in love	0
COL name VAL loreal paris true match nude fondoten serum 052 very light	COL name VAL loreal paris loreal paris true match nude fondoten serum 052 very light	1
COL name VAL loreal paris true match nude serum fondoten 23 light	COL name VAL loreal paris loreal paris true match nude fondoten serum 23 light	1
COL name VAL loreal paris kaay kalemi brow artist high contour 107 cool brown 	COL name VAL loraal paris infaillible 24h matte cover ya14ksek kapataca fondaten 00 golden beige	0
COL name VAL loreal paris likit soft emerald l quite cute infaillible lip paint sedef beyazi 201 smell of roses oh my choc 	COL name VAL loraal paris rouge signature likit mat ruj 103 i enjoy	0
COL name VAL loraal paris fighter signature eyeliner 05 g brown sugar gossipgirl	COL name VAL loreal paris infaillible lip paint likit ruj matte 207 wuthering purple	0
COL name VAL loreal paris loreal paris true match bakim yapan fondoten 4n beige	COL name VAL loreal paris loreal paris match bakim yapan fondoten 4n beige	1
COL name VAL loraal paris cast magic kazaraklak giderici cc krem	COL name VAL loreal paris kaay kalemi brow artist high contour 32 ebony 	0
COL name VAL paris loreal paris and set renkli maskara 105	COL name VAL loreal paris loreal paris brow artist plump and set renkli kas sabitleyici maskara 105 brunette	1
COL name VAL loreal paris color riche matte addiction mata ruj 633 moka chic	COL name VAL loreal paris likit metalik ruj rouge signature metallic 346 i magnetize 	0
COL name VAL loreal paris loraal paris mascara telescopic black	COL name VAL loraal paris glam shine balmy gloss 2li	0
COL name VAL loreal paris loreal paris infaillible 32h fresh wear c vitaminli fondoten 130 true beige	COL name VAL loreal paris infaillible 24h fondoten 130 true beige	1
COL name VAL loreal paris infaillible 24h redlizard wear 140 neonfuchsia sedefli acikuzum another level gaz kalemi	COL name VAL loreal paris infaillible 24h matte cover ya14ksek kapataca fondaten 200 golden sand 	0
COL name VAL loreal paris lash paradise intense black ekstra siyah maskara	COL name VAL loreal paris gaz kalemi no 5n portofino mavisi	0
COL name VAL loraal paris true match metalize me 140 v	COL name VAL loreal paris loraal paris paradise siyah maskara 64 ml	0
COL name VAL loreal paris loraal paris infaillible 32h nude pink tonlari wear burnt raisin matte vitaminli fondaten 220 chic stiletto	COL name VAL loreal paris true match bakam yapan fondaten 4d golden natural	0
COL name VAL loraal paris infallible waterproof gel crayon eyeliner 07 flash nlightsand	COL name VAL loreal paris likit mat ruj les macarons ultra matte liquid lipstick 826 mademoiselle mango 	0
COL name VAL loraal paris true match bakam yapan fondaten 6d golden honey	COL name VAL loinfaillible 24h fresh wear pudra fondaten 355r vanilla	0
COL name VAL loreal paris infaillible lip paint likit ruj matte 201 hollywood beige nude	COL name VAL loreal paris likit mat ruj infaillible lip paint matte 201 hollywood beige	1
COL name VAL loreal paris volume million lashes balm noir light medium with warm yellow middle brown maskara 89 paint it black	COL name VAL loreal paris ruj lip paint metallic 306 lolita 	0
COL name VAL loraal paris infaillible 24h fondaten 300 pink for me	COL name VAL loraal paris lumi magique fondaten spf18 r c k4	0
COL name VAL loreal paris kahverengi gaz kalemi contour khol kajal 102 espresso 	COL name VAL loreal paris stick fondaten infaillible longwear shaping stick foundation 326 caramel 633 gr 	0
COL name VAL loreal infallible noix de pecan neutre wear 24h fondaten 60 killer storm mauveclaymat	COL name VAL loraal paris glow mon amour likit aydanlataca 03 bronze in love	0
COL name VAL loreal paris amour likit 02	COL name VAL loreal paris glow mon amour likit aydinlatici 02 bellini	1
COL name VAL loreal paris amethyste acik kahve vizo maskara lash architect 4d vintagerose plum tree 	COL name VAL loreal paris ruj infallible sexy balm 201 wasted 	0
COL name VAL loraal paris color riche matte addiction ruj 640 erotique nude	COL name VAL loreal paris lumi magique concealer kapataca ve aydanlataca 206 medium	0
COL name VAL paris rouge mat ruj i explore	COL name VAL loreal paris rouge signature likit mat ruj 116 i explore	1
COL name VAL loreal paris brow artist plumpandset renkli kas sabitleyici maskara 108 dark brunette	COL name VAL loreal paris brow artist renkli kas sabitleyici maskara 108 dark brunette	1
COL name VAL loraal paris true match bakam yapan fondaten 1d golden ivory	COL name VAL loreal paris mat eyeliner matte signature eyeliner 143 burgundy 	0
COL name VAL loraal paris bone signature parisian dark tan likit tasty yaz scarlet dress 127 i revolutionize	COL name VAL loraal paris brow artist high contour 103 warm blond aaak saraayan	0
COL name VAL loreal paris karl lagerfeld collection far paleti	COL name VAL loreal paris karl lagerfeld collection far paleti 01	1
COL name VAL loreal paris infaillible 32h fresh wear c vitaminli fondoten 60 rose ivory	COL name VAL loreal paris infaillible 32h wear c fondoten 60 rose ivory	1
COL name VAL loreal paris accord parfait pdre fr 65d65w c	COL name VAL loreal paris true match pudra w1 golden ivory	1
COL name VAL loreal paris bronze please bronzlastirici pudra 04 taormina intenso	COL name VAL loreal paris bronzlastirici pudra bronze please taormina intenso 04	1
COL name VAL loreal paris true match bakam yapan fondaten 1n rainier yaz	COL name VAL loreal paris brilliant signature plump in gloss ruj 412 i heighten	0
COL name VAL loraal paris volumissime x5 gold glow gl snow globe maskara koyu leylak	COL name VAL loreal paris brow artist skinny definer kaay kalemi 104 chatain 	0
COL name VAL loreal paris mat ruj color riche matte addiction lipstick 104 pink ready to we 	COL name VAL loraal paris true match bakam yapan fondaten no2r2c beage	0
COL name VAL loraal paris infaillible lip paint likit ruj matte 205 apocalypse red karmaza	COL name VAL loreal paris suya dayanakla siyah eyeliner super liner black lacquer waterproof eyeliner 636 ml 	0
COL name VAL loraal paris electrique pink schiap duo pudra duo 102	COL name VAL loreal paris rouge signature matte likit ruj 112 achaeve	0
COL name VAL loreal paris kapatici	COL name VAL loreal paris kapatici true match concealer 2rc rose vanilla	1
COL name VAL loreal paris goz fari infaillible eyeshadow paint 101 eternal white	COL name VAL loreal paris infaillible eye paint goz fari 101 eternal white	1
COL name VAL loreal paris color riche saten bitisli ruj 143 pink pigalle pembe	COL name VAL loreal paris loreal paris color riche satin ruj 143 pink pigalle	1
COL name VAL loreal paris les chocolats likit mat ruj 856 70 yum	COL name VAL loreal paris les chocolats ultra matte liquid lipstick 856 yum	1
COL name VAL loraal paris infaillible 24h dumanlipembe 111 permanent red for me penny	COL name VAL loreal paris dudak kalemi infaillible lip pencil 205 apocalypse red 	0
COL name VAL loreal paris color riche x balmain collection rock woman mat ruj 902 legend	COL name VAL loreal paris color riche x balmain ruj 902 legend kahverengi	1
COL name VAL loreal paris rouge signature matte likit ruj 114 represent	COL name VAL loreal paris rouge signature likit mat ruj 114 i represent	1
COL name VAL loreal paris loraal paris color riche plump and shine ruj	COL name VAL loreal paris kadan 011 orange magique ruj	0
COL name VAL loraal paris les chocolats likit mat ruj 856 70 yum	COL name VAL loreal paris infaillible 24h matte cover ya14ksek kapataca fondaten 05n rose porcelain 	0
COL name VAL loreal paris vermillon color riche lipstick 238 lightmediumwithneutral after 	COL name VAL loreal paris unbelieva brow uzun sa14re kalaca kaay jeli 105 brunette	0
COL name VAL loreal paris eye go wild goz fari paleti	COL name VAL loreal paris eye go wild paleti	1
COL name VAL loraal paris color dark tekli gaz fara 15 perceverance	COL name VAL loraal paris matte signature eyeliner 07 copper turuncu	0
COL name VAL loreal paris glow deep ocean nocolor fabb balm in lipstick 244 golden pink freedom kayasa  244	COL name VAL loreal paris caresse lipstick ruj 202	0
COL name VAL loreal paris dudak kalemi infaillible lip pencil 207 wuthering hakiyesili	COL name VAL loraal paris infaillible ta14m ya14ze uygulanabilir kapataca 323 fawn	0
COL name VAL loreal paris infallible eye paint no 305 peach me babe	COL name VAL loreal paris goz fari infallible paint nude eyeshadow peach me babe	1
COL name VAL loreal paris unlimited maskara siyah	COL name VAL loraal paris true match bakam yapan fondaten 11ml golden sand	0
COL name VAL loraal paris color riche dudak kalemi 285 pink fever pembe	COL name VAL loreal paris infaallable gel crayon 24h eyeliner 052 purple	0
COL name VAL loraal paris lash architect 4d pn maskara	COL name VAL loraal paris superliner smokissime eyeliner taupe	0
COL name VAL loreal paris brow artist skinny definer kas kalemi 108 dark brunette	COL name VAL loreal paris brow artist skinny definer kas kalemi 108 dark brunette	1
COL name VAL loreal paris infaillible 24h hilight cover ya14ksek kapataca fondaten 290 love yourself kirem 	COL name VAL loraal paris infaillible ta14m ya14ze uygulanabilir kapataca 323 fawn	0
COL name VAL loreal paris loraal paris glow mon cherry wild child likit aydanlataca 02 loving raspberry creamy	COL name VAL loreal paris micellar makyaj temizleme suyu normalden ve karmaya hassas ciltler iain	0
COL name VAL loreal paris paradise siyah	COL name VAL loreal paris paradise siyah maskara	1
COL name VAL loreal paris nude magique cushion fondoten 11 golden amber	COL name VAL loreal paris likit kompakt fondoten nude magique liquid cushion foundation 11 golden amber	1
COL name VAL loraal paris lash arch 4d black lacqu black mascara	COL name VAL loreal paris aa etkili micellar kusursuz makyaj temizleme suyu 07 ml 	0
COL name VAL loreal paris ruj kalem matte lip crayon 110 caramel rebel	COL name VAL loreal paris infaillible matte lip crayon kalem mat ruj 110 caramel rebel	1
COL name VAL loreal paris infaillible 24h goz kalemi 301 night day black	COL name VAL loreal paris siyah eyeliner infallible eye stylo eyeliner 16h 301 night day black	1
COL name VAL loraal paris color riche buttabiscuit addiction en koyu ten 349 paris golden mauve burgundy turuncu sari	COL name VAL loraal paris paradise siyah maskara	0
COL name VAL loreal paris true match fondaten 3n creamy beige	COL name VAL loraal paris color riche plump and shine ruj 108 nectarine plump	0
COL name VAL loraal paris mega volume collagene 24h maskara siyah	COL name VAL loreal paris ral infmacaronsnu ruj 852 dose of ros	0
COL name VAL loreal paris superliner tattoo signature liner ekstra siyah	COL name VAL loreal paris ekstra siyah likit eyeliner superliner tattoo signature liner	1
COL name VAL loreal paris karl collection far paleti	COL name VAL loreal paris karl lagerfeld collection far paleti	1
COL name VAL loreal paris loraal volumissime royale x10 maskara siyah 2 adet set	COL name VAL loraal paris infaillible eye paint gaz fara 355r goldeneye	0
COL name VAL loreal paris loreal paris emotions of nu allik ve far paleti goz fari	COL name VAL loreal paris loreal emotions ve far fari	1
COL name VAL loreal paris likit mat ruj les macarons ultra matte liquid lipstick 832 strawberry sauvage	COL name VAL loreal paris les macarons likit mat ruj 832 strawberry sauvage	1
COL name VAL loraal paris infaillible 24h fondaten 130 true beige	COL name VAL loraal paris les chocolats likit mat ruj 010 volupto choco	0
COL name VAL loreal paris loreal paris true match bakim yapan fondoten 4n beige	COL name VAL loreal paris true match bakim yapan fondoten 4n beige	1
COL name VAL loreal paris loreal infallible automatic eyeliner yoayun siyah	COL name VAL loreal paris loraal paris true match bakam yapan fondaten 225 linen	0
COL name VAL loreal paris ruj color riche free the nudes 04 no cage	COL name VAL loreal paris nude ruj no 04 color riche free no cage	1
COL name VAL loreal paris infaillible sexy balm ruj 111 go pretty or go home	COL name VAL loreal paris ruj infallible sexy balm 111 go pretty or go home	1
COL name VAL loreal paris tattoo kirmizi liner signature moon lust noir angora gaz kalemi 03 	COL name VAL loreal paris lip liner couture by color riche 374 intense plum	0
COL name VAL loraal paris color riche plump and shine lacivert 101 aciksutlukahve plump	COL name VAL loreal paris paris aydanlataca palet en glow cool glow	0
COL name VAL loreal paris goz kalemi no 107 kot mavisi	COL name VAL loreal paris cr khol kajal 138 blue	1
COL name VAL loraal paris mega gloss lip gloss 509 you know you sf me	COL name VAL loreal paris glam bronze powder 04	0
COL name VAL loraal paris infaillible shaping stick allak 001 sexy flush	COL name VAL loreal paris infaillible 24h matte fondaten 643 beage dore	0
COL name VAL loreal paris kahverengi eyeliner infallible stylo eyeliner 16h 300 chocolate addict	COL name VAL loreal paris infaillible 24h goz kalemi 300 chocolate addiction	1
COL name VAL loreal paris color richa ultra normalten goldenrose yesil kahve moulin rouge 6 hesitation	COL name VAL loreal paris true match bakam yapan fondaten 3n creamy beige	0
COL name VAL loreal paris likit haute burgundy dalgali mavi les macarons ultra higlight on point liquid lipstick 830 blackcurrant m rosewood shine 	COL name VAL loraal paris true match prestige pudra 3d golden beige	0
COL name VAL loraal paris cast magic bb krem 03 medium light	COL name VAL loreal paris loreal color queen tekli gaz fara 5d5w stunner	0
COL name VAL loraal paris true match roller n4 buff beige	COL name VAL loraal paris matte signature eyeliner 12 ink siyah	0
COL name VAL loreal paris dore tonlarinda aydinlatici true match highlight 101d 101w golden glow	COL name VAL loreal paris true match highlight aydinlatici 101d101w dore	1
COL name VAL loreal paris true match kapataca 7dw glitzy gold nocolor cfdde	COL name VAL loreal paris bambi eye extra black ceylan gaz etkili maskara ekstra siyah	0
COL name VAL loreal paris paris waterproof crayon eyeliner 16 yogunrenkverenparlakoje ml	COL name VAL loreal paris telescopic gold siyah maskara and infaillible 24h fresh wear pudra fondaten 40 cashmere	0
COL name VAL loreal paris gl snow globe darknude maskara	COL name VAL loreal paris paradise intense black ekstra siyah maskara x 2	0
COL name VAL loreal paris mega volume miss manga maskara	COL name VAL loreal paris siyah maskara miss manga	1
COL name VAL loraal paris porcelain ivory mat ve kadifemsi liner signature gaz kalemi 04 pink stone trans siberian	COL name VAL loraal paris true match bakam yapan fondaten 55d golden sun	0
COL name VAL loreal paris yesil eyeliner infaillible gel crayon eyeliner 08 kaki	COL name VAL loreal paris infaillible paint gel crayon eyeliner 08 rest in kaki	1
COL name VAL loreal paris color riche carmine elixir addiction my little secret 655 l spicy chili clutch	COL name VAL loreal paris mat ruj color riche matte addiction 358 lava 	0
COL name VAL loreal paris color riche shine addiction lipstick ruj	COL name VAL loreal color riche shine addiction lipstick ruj	1
COL name VAL loreal paris concealer lumimagic dark	COL name VAL loreal paris kapatici and aydinlatici lumimagic highlighter pen 03 dark	1
COL name VAL loreal paris true match fondoten c7 ambre rose	COL name VAL loreal paris nemlendirme etkili fondoten true match foundation c7 rose amber 30 ml	1
COL name VAL loreal paris volume million lashes feline maskara	COL name VAL loreal paris siyah maskara volume million lashes feline mascara black	1
COL name VAL loreal paris mat ruj color riche matte addiction lipstick 348 brick vintage	COL name VAL loreal paris color riche matte addiction ruj 348 brick vintage	1
COL name VAL loreal paris goldbej color riche free the siyahkalincizgi 06 matte brown mahogany hesitation 	COL name VAL loraal paris micellar kusursuz makyaj temizleme suyu normal 400ml	0
COL name VAL loraal paris color queen tekli gaz fara 36 charmer	COL name VAL loreal paris kaay kalemi brow artist high contour 3r ebony 	0
COL name VAL loreal paris 24 saat kalici kalem no 306 stay blue	COL name VAL loreal paris infaillible eye liner 306 stay blue	1
COL name VAL loreal paris loreal paris telescopic carbon black maskara siyah 8 mlmaskara	COL name VAL loreal paris loreal paris telescopic maskara	1
COL name VAL loreal paris loreal paris true match bakam yapan fondaten 2r rose vanillatrue match kapataca 2rc rose vanilla	COL name VAL loraal paris rouge signature likit mat ruj 818 i dont	0
COL name VAL loreal paris ruj color riche exclusive pinks evas pink	COL name VAL loreal paris color riche la vie en rose ruj evas pink	1
COL name VAL loreal paris loraal paris true match bakam yapan fondaten 15 tiramisu medium	COL name VAL loreal paris les macarons ultra matte liquid lipstick ruj 820 pral	0
COL name VAL loreal paris likit mat ruj infallible lip paint matte 203 tangerine vertigo 	COL name VAL loreal paris parlataca ruj rouge signature lip topper 350 white gold 	0
COL name VAL loreal paris bambi eye ceylan gaz etkili siyah maskara	COL name VAL loreal paris kapataca true match concealer 828 beige	0
COL name VAL loreal paris dudak kalemi color riche crayon liner 461 deep red plum kirli hardal 	COL name VAL loreal paris highlighting fashaon collab 00 unave	0
COL name VAL loreal paris infaillible matte lip crayon kalem mat ruj 113 brulee everyday	COL name VAL loreal paris matte lip crayon no 113 brulee everday kalem mat ruj	1
COL name VAL loreal paris les macarons likit mat ruj 834 infinite spice	COL name VAL loreal paris ral infmacaronsnu ruj 834 infinite sp	1
COL name VAL loreal paris gleam invitation petal fresh lap crayon 103 maple dream	COL name VAL loreal paris loreal ceylan gaz etkili ekstar siyah maskaramaybelline kajal gaz kalemi	0
COL name VAL loraal paris infaillible eye paint gaz fara 302 immortal black	COL name VAL loraal paris melon dollar embel blush 206 watermelon	0
COL name VAL loreal paris stick fondaten infaillible shaping stick fondaten 190 m nfallinocean nude flush 	COL name VAL loreal paris loreal paris mega volume collagene 24h siyah maskara maskara	0
COL name VAL loraal paris infaillible ta14m ya14ze uygulanabilir kapataca 322 ivory	COL name VAL loraal paris rouge signature likit mat ruj 65d i rebel	0
COL name VAL loreal paris color riche unsurpassed volume winered chili 346 acik determination	COL name VAL loreal paris loreal paris telescopic mascara maskara	0
COL name VAL loreal paris chilipepper signature nocolor dcec likit give a glam 109 pudrapembetonlari	COL name VAL loreal paris mat ruj color riche matte addiction lipstick 633 moka chic nude 	0
COL name VAL loreal paris loraal paris true match pudra w5 golden sand	COL name VAL loreal paris infaillible matte lip crayon kalem mat ruj 247 brulae everyday	0
COL name VAL loreal paris goz fari paleti la palette nude 002 beige	COL name VAL loreal paris color riche la palette nude far paleti beige	1
COL name VAL loreal paris medium peach eb color riche shine pl alpine rose tans 659 blow your glow renkkod 	COL name VAL loreal paris les chocolats likit mat ruj 852 box of chocolates	0
COL name VAL loreal paris loreal paris signature plump gloss ruj i insert	COL name VAL loreal paris loreal paris brilliant signature plump in gloss ruj 404 i insert	1
COL name VAL loraal paris rouge caresse ruj 07 cheeky magenta	COL name VAL loreal paris siyah eyeliner infaillible gel crayon eyeliner 868 black 	0
COL name VAL loreal paris dudak kalemi infaillible lip pencil 701 stay ultraviolet	COL name VAL loreal paris true match bakam yapan fondaten 113 creamy beige	0
COL name VAL loreal paris color riche les nus ruj 176 nu irrevent	COL name VAL loreal paris loreal paris color riche les nus ruj 176 nu irrevent	1
COL name VAL loreal paris kas kalemi brow artist xpert 109 ebony	COL name VAL loreal paris brow artist xpert no 109 ebony	1
COL name VAL loreal les macarons ultra matte likit ruj 832 strawberry	COL name VAL loreal paris les macarons ultra matte likit ruj 832 strawberry	1
COL name VAL loreal paris iconic glow aydinlatici pudrahighligter 2020 no01 coco feve	COL name VAL loreal paris highlighter 2020 icoconic glow 01 coconut addict	1
COL name VAL loraal paris parisdisco faraasa blending brush karaaytarma faraasa	COL name VAL loraal paris color riche plump and shine ruj 108 wild fig plump	0
COL name VAL loreal paris rimel volume mallaon lashes cannes azel tasaram siyah	COL name VAL loreal paris color riche intense volume matte ruj 23 rouge determination	0
COL name VAL loreal paris kizilturuncu color riche free the killer gingerbread 05 plumwine diktat	COL name VAL loreal paris ruj lap paant matte 204 red actually	0
COL name VAL loreal paris true match bakam yapan fondaten 1n sable sand fondaten	COL name VAL loreal paris allak true match le blush no 160 peach 	0
COL name VAL loreal paris eye extra black ceylan goz etkili maskara ekstra siyah 	COL name VAL loreal paris bambi eye extra black ceylan goz etkili maskara ekstra siyah 	1
COL name VAL loreal true match bakim yapan fondoten 45n beige	COL name VAL loreal paris true match bakim yapan fondoten 45n true beige	1
COL name VAL loreal paris rouge signature empowereds likit mat ruj 141 discovered	COL name VAL loreal paris rouge signature empowereds likit mat ruj 141 discovered	1
COL name VAL loreal paris y nrosewood yilantaba superliner superliner nocolor ecba matic 03 white pearlescent pom pom macaron 	COL name VAL loreal paris rouge signature likit mat ruj 113 i dont	0
COL name VAL loreal paris color riche shine addiction lipstick 466 beauty queen ruj	COL name VAL loreal paris color riche shine ruj	1
COL name VAL loreal paris rouge signature parisian sunset likit mat ruj 129 i lead	COL name VAL loreal paris rouge signature parisian sunset likit mat ruj 129lead	1
COL name VAL loreal cr khol kajal 138	COL name VAL loreal paris cr khol kajal 138 blue	1
COL name VAL loreal paris jel kaay pomada brow artist pomade no 104 brunette 	COL name VAL loraal paris glow mon amour melon dollar baby likit aydanlataca no04 32 ml	0
COL name VAL loreal paris mavi gaz kalemi contour khol portofino blue 	COL name VAL loraal paris infaillible 24h ruj 110 permanent blush nude	0
COL name VAL loreal paris infaillible 24h matte fondoten 30 miel honey	COL name VAL loreal paris infaillible 24h matte 30 honey 35 ml mat fondoten 	1
COL name VAL loraal paris true match bakam yapan fondaten 8r nut dirty thirty	COL name VAL loreal paris infaillible 24h matte cover ya14ksek kapataca fondaten 175 sablesand 	0
COL name VAL loreal paris mat ruj color riche matte addiction 909 amulet	COL name VAL loraal paris infallible 305	0
COL name VAL loraal paris brow city color high contour 107 nthatsrosewood wanna play starry rose creamcashmere	COL name VAL loreal paris color queen tekli gaz fara 34 gilded	0
COL name VAL loreal paris ruj color riche shine addiction lipstick 352 yolo 	COL name VAL loraal paris color riche intense volume matte ruj 140 nude independant	0
COL name VAL loreal paris loraal paris infaillible 32h serenity wear fuchsia spark fusya vitaminli fondaten 140 drenk on and on bronze	COL name VAL loreal paris loraal paris color riche plump and shine ruj	0
COL name VAL loreal paris paradise extatic siyah maskara	COL name VAL loreal paris gaz fara infallible eyeshadow paint 052 iconic silver 	0
COL name VAL loreal paris likit gbs dark grape les chocolats ultra rayon rays liquid lipstick 868 brown rush 	COL name VAL loraal paris rouge signature metallic likit ruj 204 i voodoo	0
COL name VAL loreal paris true match bakam yapan fondaten 2n vanilla	COL name VAL loreal paris color riche ruj matte 001 androgyne	0
COL name VAL loraal paris cast magic kazaraklak giderici peachmebabe chubby	COL name VAL loreal paris pudra true match powder 3r3c rose beige 	0
COL name VAL loreal paris telescopic carbon black maskara siyah and infaillible 24h fresh wear pudra fondaten 120 vanilla	COL name VAL loreal paris pudra true match powder 300 vanilla 	0
COL name VAL loreal paris ruj infallible mega gloss 407 smoke me up	COL name VAL loreal paris mega gloss lip gloss 407 smoke me up	1
COL name VAL loreal paris loreal paris true match nude fondoten serum 052 very light	COL name VAL loreal paris true match nude fondoten serum 052 very light	1
COL name VAL loreal paris lash paradise intense black ekstra siyah maskara	COL name VAL loraal paris infaillible metallic lip paint 2018 lolita	0
COL name VAL loreal paris kaay kalemi brow artist high contour 108 warm brown 	COL name VAL loreal paris true match bakam yapan fondaten 335 golden beage	0
COL name VAL loreal paris kadin pembe dolgunlastirici mat ruj 106	COL name VAL brow uzun kalici seffaf kas maskarasi	0
COL name VAL loreal paris color riche les nus ruj 179 decadent	COL name VAL loreal paris color riche les nus ruj 179 nu decadent	1
COL name VAL loreal paris true match bakam yapan fondaten 5d retro ruby trailblazer	COL name VAL loraal paris true match bakam yapan fondaten 05n porcelaan	0
COL name VAL loreal paris loreal paris true match bakim yapan fondoten 4n beige	COL name VAL loreal paris paris true match bakim yapan 4n beige	1
COL name VAL loreal paris loreal micellar makyaj temizleyici paradise intense maskara seti	COL name VAL loraal paris color queen tekli gaz fara 633 influence	0
COL name VAL loreal paris color riche shine ruj 642 mlbb nude	COL name VAL loreal paris loreal paris glow paradise balminlipstick isilti veren ruj 642 beige eden	1
COL name VAL loreal paris true match bakam yapan fondaten 2n vanilla	COL name VAL loraal paris infaillible dudak kalemi 27 stay ultraviolet pembe	0
COL name VAL loreal paris nocolor fffc sparkling matte rose bonjour nudista rosefome yellow 04 happy red r gsg 	COL name VAL loreal paris paris waterproof crayon eyeliner 17 christmas	0
COL name VAL loreal paris zebrra desen liner signature lightplus gaz kalemi 09	COL name VAL loreal paris color riche ruj matte addiction 349 cherry front	0
COL name VAL loreal paris ruj infallible sexy balm 103 as if 	COL name VAL loraal paris bronze please bronzlaaytaraca pudra 642 amalfi medio	0
COL name VAL loreal paris loraal paris lash paradise intense black ekstra siyah maskara 2li set 1 paket 1 x 2 adet	COL name VAL loreal paris allak paleti infallible blush palette 8n pink 	0
COL name VAL loraal paris color riche ruj exclusive reds evas pure red	COL name VAL loreal paris bronze please bronzlaaytaraca pudra 360052 amalfi 	0
COL name VAL loraal paris bronze please bronzlaaytaraca pudra 04 taormina intenso	COL name VAL loraal paris color queen tekli gaz fara 848 flaming	0
COL name VAL loreal paris likit dc throwback rose color riche lextraordinaire lipstick 101 pempe inci melody 	COL name VAL loreal paris loraal paris hacim veren maskara siyah	0
COL name VAL loraal paris true match kapataca 2n orange popsicle	COL name VAL loreal paris paris kaay kalemi and aydanlataca 105 brunette	0
COL name VAL loreal paris nocolor eaf sicak bej bonjour nudista acikkiremit kul 04 parfait lightsalmon 	COL name VAL loreal paris les chocolats ultra matte likit ruj 856 70 yum	0
COL name VAL loreal paris color riche ruj exclusive reds jlos pure red	COL name VAL loreal paris ruj color riche exclusive reds jlos red	1
COL name VAL loreal paris color riche x balmain collection safari woman mat ruj 648 glamazone	COL name VAL loreal paris color riche safari woman mat ruj 648 glamazone	1
COL name VAL loraal paris infaillible ta14m ya14ze uygulanabilir kapataca 326 vanilla	COL name VAL loreal paris infaillible 24h fresh wear pudra fondaten 128 golden beige	0
COL name VAL loreal paris bambi eye stay ultraviolet neon radioactive ceylan gaz etkili maskara ekstra k met	COL name VAL loraal paris infaillible shaping stick fondaten 220 caramel	0
COL name VAL loreal paris brow artist high contour 107 cool brunette koyu kumral	COL name VAL loreal paris brow artist high 107 cool brunette koyu kumral	1
COL name VAL loreal paris infaillible 24h fondoten 140 beige dore	COL name VAL loreal paris fondoten infallible golden bej	1
COL name VAL loraal paris bambi oversized eye maskara red velvet cake	COL name VAL loreal paris aydanlataca paleti 02 cool glowlionesse barbie makyaj faraasa 002	0
COL name VAL loraal paris color riche shine pigmentlifusya 350 stay ultravio karmaza	COL name VAL loreal paris infaillible 24h matte cover ya14ksek kapataca fondaten 200 golden sand 	0
COL name VAL loraal paris color riche saten bitiayli orta mavi 143 cabosanlucas matgulpembe lavender for fair to light skin tones cashew for medium to tan skin tones	COL name VAL loreal paris infaillible 24h matte cover ya14ksek kapataca fondaten 115 golden beige	0
COL name VAL loreal paris ruj color riche free the nudes 08 no lies	COL name VAL loreal paris color riche free the nudes ruj no lies	1
COL name VAL color quad goz fari unforgettable	COL name VAL loreal paris color riche quad goz fari e7 unforgettable lilac	1
COL name VAL loraal paris color riche plump and shine ruj 107 coconut plump	COL name VAL loraal paris infaillible 24h fresh wear pudra fondaten 313 rose sand	0
COL name VAL loreal paris bambi eye ceylan goz etkili maskara siyah x2	COL name VAL loreal paris ceylan etkili siyah	1
COL name VAL loreal paris ruj infallible mega gloss 102 scream and shout 	COL name VAL loreal paris loraal paris glow paradise balm in lipstick iayalta veren ruj 313 beige eden	0
COL name VAL loreal paris brow artist high contour 102 cool blond sarisin	COL name VAL loreal paris kas kalemi brow artist high contour 102 cool blonde	1
COL name VAL loreal paris kadin 163 orange	COL name VAL loreal paris kadin 163 orange magique ruj	1
COL name VAL loreal paris les chocolats likit mat ruj 868 cacao rush	COL name VAL loreal paris les chocolats ultra matte likit ruj 868 cacao crush	1
COL name VAL loreal paris mat pudra infaillible 24h ultra matte prestige pudra 160 sand beige	COL name VAL loreal paris infaillible 24h ultra matte prestige pudra160 sand beige	1
COL name VAL loraal paris ruby shock signature likit mcr nocolor faad 109 i golden red	COL name VAL loreal paris likit mat ruj les chocolats ultra matte liquid lipstick 864 tasty ruby 	0
COL name VAL loreal paris les macarons likit mat ruj 830 blackcurrant crush	COL name VAL loreal paris les macarons ultra matte likit ruj 830 blackcurrant	1
COL name VAL loreal paris color riche les nus ruj 179 nu decadent	COL name VAL loreal paris color riche les nus ruj 179 decadent	1
COL name VAL loreal paris les chocolats likit werk bedrose 862 volupto nocolor abfdabd	COL name VAL loreal paris bambi eye ceylan gaz etkili maskara siyah	0
COL name VAL loraal paris brilliant signature plump in gloss taslidesenli 412 i tatli mavi	COL name VAL loraal paris color riche matte addiction ruj 654 bronze sautoir kahverengi	0
COL name VAL loreal paris tekli gaz fara color brunette mono eyeshadow 16 determination 	COL name VAL loreal paris unlimited siyah maskara 2 li set	0
COL name VAL loreal paris rouge caresse ruj 07 cheeky magenta	COL name VAL loreal paris ruj labial color riche caresse lipstick 07 cheeky magenta	1
COL name VAL loraal paris color riche free the amethyste macao what in carnation doubts	COL name VAL loreal paris loraal paris true match bakam yapan fondaten 7d golden amber	0
COL name VAL loreal paris loreal infaillible more than concealer 322 wisteria purple ivore 11ml	COL name VAL loreal paris telescopic maskara siyah	0
COL name VAL loraal paris infaillible 24h fondaten 120 cok acik krem	COL name VAL loraal paris air mega volume maskara 30 saate kadar kalaca ekstra siyah	0
COL name VAL loreal paris likit ruj infallible lip paint lacquer 103 fuchsia wars	COL name VAL paris likit ruj paint	1
COL name VAL loreal paris aydanlataca paleti 02 cool glowlionesse barbie makyaj faraasa 002	COL name VAL loreal paris ruj color riche lipstick 634 467 place ven 	0
COL name VAL color riche addiction ruj mor	COL name VAL loreal paris color riche matte addiction ruj 473 obsidian mor	1
COL name VAL loreal paris bronze bronzlaaytaraca pudra amalfi medio 03	COL name VAL loraal paris infaillible shaping stick aydanlataca 602 slay in rose	0
COL name VAL loreal paris kapatici true match concealer 2rc rose vanilla	COL name VAL loreal paris true match kapatici 2rc rose vanilla	1
COL name VAL loreal paris brow artist plump andamp set dolgun gorunum veren kas sabitleyici maskara 101 blonde	COL name VAL loreal paris loreal paris brow artist plump and set dolgun gorunum veren kas sabitleyici maskara 101 blonde	1
COL name VAL loreal paris les chocolats likit mat ruj 862 volupto choco	COL name VAL loreal paris les chocolats likit mat ruj 862 volupto choco	1
COL name VAL loreal paris loraal paris infaillible 32h nudekahve wear pink glow vitaminli fondaten 130 true degrade gul kurusu	COL name VAL loraal paris infaillible ta14m ya14ze uygulanabilir kapataca 326 vanilla	0
COL name VAL loreal paris infaillible 24h matte cover yuksek kapatici fondoten	COL name VAL loreal paris infaillible 24h matte cover yuksek kapatici fondoten 135 radiant vanilla	1
COL name VAL loraal paris infaillible 24h matte cover ya14ksek kapataca fondaten 145 rose beige	COL name VAL loreal paris true match bakam yapan fondaten 37 rose beage	0
COL name VAL loraal paris superliner gel intenza m satin black eyeliner	COL name VAL loreal paris loreal true match nude serum fondaten light medium fondaten faraasa	0
COL name VAL loreal paris infaillible 24h matte cover yuksek kapatici fondoten 25 rose ivory 	COL name VAL loreal paris infaillible matte yuksek fondoten rose ivory 	1
COL name VAL loreal paris loreal paris chroma neon liner 21 electric zoo eyeliner	COL name VAL loreal paris chroma neon liner 21 electric zoo	1
COL name VAL loreal paris infallible mattifying base beige ambre	COL name VAL loraal paris true match prestige pudra 2n vanilla	0
COL name VAL loreal paris true match kapatici 7dw golden	COL name VAL loreal paris true match kapatici 7dw golden amber	1
COL name VAL loraal paris infaillible ta14m ya14ze uygulanabilir kapataca 338 honey	COL name VAL loreal paris rouge signature matte likit ruj 848 achaeve	0
COL name VAL loreal paris mat ruj color riche matte addiction lipstick 633 moka chic nude	COL name VAL loreal paris riche naked tans ruj 656 beige in the city nude	0
COL name VAL loreal paris rouge signature matte likit ruj 109 savor	COL name VAL loreal paris likit mat ruj rouge signature 109 savor	1
COL name VAL loreal paris color riche ruj matte addiction 349 cherry front	COL name VAL loreal paris color riche matte addiction ruj 349 paris cherry bordo	1
COL name VAL loreal paris true match foundation 3n creamy beige fondoten	COL name VAL loreal paris fondoten true match foundation 3n creamy beige	1
COL name VAL loreal paris brow redstiletto plumpandset g kaay moon grey maskara 108 beige sable ortaton	COL name VAL loreal paris konta14r paleti infallible sculpt contouring palette 03 mediumdark 	0
COL name VAL loreal paris goz kalemi no 108 portofino mavisi	COL name VAL loreal paris mavi goz kalemi contour khol portofino blue	1
COL name VAL loreal paris kalem ruj no 915	COL name VAL loreal paris glam shine balmy gloss 915	1
COL name VAL loreal paris color riche ruj matte 130 androgyne	COL name VAL loreal paris ruj color riche lipstick 130 androgyne	1
COL name VAL loreal paris allik paleti infaillible blush palette 02 amber	COL name VAL loreal paris infaillible blush paint palette 02 ambers	1
COL name VAL paris true match n7 ambre	COL name VAL loreal paris true match fondoten n7 ambre	1
COL name VAL loreal paris color riche dudak kalemi 285 pink fever pembe	COL name VAL loreal paris dudak kalemi color riche crayon liner 285 pink fever	1
COL name VAL loraal paris rouge signature likit mat ruj 116 i explore	COL name VAL loreal paris siyah maskara false lash superstar x fiber mascara 17 black 	0
COL name VAL loraal paris true match powder w7 cinnamon	COL name VAL loraal paris true match pudra 6 beige	0
COL name VAL loreal paris loreal paris infaillible 2step 24 saat kalici likit ruj and balm 804 Metroproof rose	COL name VAL loreal paris loeral infaillable lipstick 2 steps 804metro proo	1
COL name VAL loreal paris likit aydanlataca glow mon metallic hyacinth droplet highlight 03 purple scarlet in brownmetal 	COL name VAL loeral infaillable lipstick 2 steps 312 incessant	0
COL name VAL loreal paris les macarons ultra matte liquid lipstick ruj 820 pral	COL name VAL loreal paris likit mat ruj les macarons ultra matte liquid lipstick 820 praline de	1
COL name VAL loreal paris loreal paris true match bakim yapan fondoten 4n beige	COL name VAL loreal paris true match bakim yapan fondoten 4n beige	1
COL name VAL loraal paris dusk rose liner signature gaz kalemi 02 light honey jersey	COL name VAL loraal paris true match nude fondaten serum 3 4 light medium	0
COL name VAL loreal paris infaillable automatic jel gaz kalemi yoayun tatliportakali	COL name VAL loreal paris bambi eye extra black ceylan gaz etkili maskara ekstra siyah	0
COL name VAL loreal paris bambi eye ceylan gaz etkili maskara siyah x 2	COL name VAL loraal paris infaillible dudak kalemi 412 higlight on point nude	0
COL name VAL loreal paris loreal paris true match nude fondoten serum 23 light	COL name VAL loreal paris true match nude fondoten serum 23 light	1
COL name VAL loreal paris true match bakam yapan fondaten 3r rose beige	COL name VAL loraal paris color riche saten bitiayliruj 131 maison marais karmaza	0
COL name VAL loreal paris golden beige	COL name VAL loreal paris infaillible 24h fondoten 140 golden beige	1
COL name VAL loreal paris bronzlastirici pudra bronze please taormina intenso 04	COL name VAL loreal paris bronze please bronzlastirici pudra 04 taormina intenso	1
COL name VAL loraal paris infaillible eye paint gaz fara 102 auburn soft pink the mvp	COL name VAL loreal paris loraal paris color riche plump and shine ruj	0
COL name VAL loreal paris anfaillible eye liner 306 stay blue	COL name VAL loreal paris kapataca true match concealer 8r beige	0
COL name VAL loraal paris color riche shine golden green tans metalik safir 659 blow your glow warm chestnut	COL name VAL loreal paris le liner signature kahverengi gaz kalemi 05	0
COL name VAL loreal paris true match allik 165 rosy cheeks	COL name VAL loreal paris allik true match le blush no 165 rose bonne mine	1
COL name VAL loreal paris kaay kalemi brow orta koyu high contour 103 happy go rosy velvet beige 	COL name VAL loreal paris dudak kalemi infaillible lip pencil 101 gone with the nude 	0
COL name VAL loreal paris true match bakim yapan fondoten 45n true beige	COL name VAL loreal paris true match bakim yapan fondoten 45n true beige	1
COL name VAL loreal paris ceylan gaz etkili ekstar maskara siyah maybelline new york kajal gaz kalemi	COL name VAL loreal paris loraal paris infaillible 24h fondaten 410 radiant honey	0
COL name VAL loreal paris kontur paleti infallible sculpt contouring palette 01 light	COL name VAL loreal paris infaillible sculpt palette kontur paleti 01 light medium	1
COL name VAL loreal paris paris waterproof crayon eyeliner 17 christmas	COL name VAL loreal paris loraal paris infaillible 302 fresh wear c vitaminli fondaten 404 natural linen	0
COL name VAL loreal paris true match bakam yapan fondaten 1n ivory	COL name VAL loreal paris stick fondaten infaillible shaping stick fondaten 356 vanilla 	0
COL name VAL loreal paris mat les ultra dose of ros	COL name VAL loreal paris likit mat ruj les macarons ultra matte liquid lipstick 818 dose of ros	1
COL name VAL loreal paris pudra true match powder 3d 3w golden beige 	COL name VAL loreal paris mat ruj color riche matte addiction 470 lava 	0
COL name VAL loreal paris mega gloss lip gloss 107 whos the boss	COL name VAL loreal paris ruj infallible mega gloss 107 whos the boss	1
COL name VAL loreal paris infaillible yuze pecan	COL name VAL loreal paris infaillible tum yuze uygulanabilir kapatici 330 pecan	1
COL name VAL loraal paris infaillible 24h plums 217 perfect crimson vamp ma14rda14m	COL name VAL loreal paris loreal color riche lipstick 125	0
COL name VAL loraal paris cherie on the cake allak ve bronzlaaytaraca pudra 02 nepal isiltili acik gul qd cherry dessert	COL name VAL loraal paris telescopic carbon black maskara siyah 2li set	0
COL name VAL paris true match bakim yapan creamy	COL name VAL loreal paris true match bakim yapan fondoten 3n creamy beige	1
COL name VAL loraal paris au natural signature parisian love wins likit violet flash pempe inci 132 i radiate	COL name VAL loreal paris gaz fara color riche quad e7 lilas cheri 	0
COL name VAL loraal paris infaillible ortkoyu lip paint 301 pixie	COL name VAL loreal paris likit aydanlataca glow mon amour droplet highlight	0
COL name VAL loreal paris mavi goz kalemi contour khol portofino blue	COL name VAL loreal paris contour khol 108 portofino blue goz kalemi	1
COL name VAL loreal paris color queen tekli gaz fara 34 gilded	COL name VAL loraal paris color riche matte addiction ruj 94ml strike a rose pembe	0
COL name VAL loreal paris loreal paris uzun sure kalici kas jeli unbelieva brow 105 brunette	COL name VAL loreal paris unbelieva brow uzun sure kalici kas jeli 105 brunette	1
COL name VAL loreal botanicals loreal infallible longwear shaping stick 501	COL name VAL loreal botanicals infallible longwear shaping stick 501	1
COL name VAL loreal paris likit mat ruj rouge signature 109 savor	COL name VAL loreal paris rouge signature likit mat ruj 109 i savor	1
COL name VAL loreal paris infaillible 24h fondoten 150 radiant eclat	COL name VAL loreal paris infaillible 24h fondoten radiant	1
COL name VAL loraal paris rouge signature likit mat ruj 109 i savor	COL name VAL loraal paris infaillible ta14m ya14ze uygulanabilir kapataca 818 fawn	0
COL name VAL loreal paris parlak eyeliner xmas glitter liner paris disco 	COL name VAL loreal paris likit mat ruj les chocolats ultra matte liquid lipstick 111 oh my choc 	0
COL name VAL loreal paris shore pudra infaillible 24h ultra hotspice prestige pudra 160 dainty idon t 	COL name VAL loraal paris color riche free the nudes ruj no diktat	0
COL name VAL loreal paris ruj glam shine balmy gloss 912	COL name VAL loreal balmy gloss 912	1
COL name VAL loreal paris true match bakam yapan fondaten 1d medium macadamia seftali tabanli orta koyu w mediumwithwarmgolden	COL name VAL loraal paris infaillible ta14m ya14ze uygulanabilir kapataca 334 walnut	0
COL name VAL loreal paris cast magic lasting passion strawberry red 1 anti nocolor ecaf softemerald enhancer 	COL name VAL loreal paris true match bakam yapan fondaten 1d golden ivory	0
COL name VAL loreal paris infaillible 24h ultra matte prestige pudra225 beige	COL name VAL loreal paris mat pudra infaillible 24h ultra matte prestige pudra 225 beige	1
COL name VAL loreal paris loreal paris telescopic mascara maskara	COL name VAL loreal paris paris mascara maskara	1
COL name VAL loreal paris rouge signature likit mat ruj 105 rule	COL name VAL loreal riche plump and 104 guava plump	0
COL name VAL loreal paris bronz pudra glam bronze powder 102 brunette harmony	COL name VAL loreal paris glam bronze powder 102	1
COL name VAL loreal paris loreal paris infaillible tum yuze uygulanabilir kapatici 321 eggshell	COL name VAL loreal paris infaillible tum yuze uygulanabilir kapatici 321 eggshell	1
COL name VAL loraal paris true match prestige pudra 2n vanilla	COL name VAL loreal paris jel siyah eyeliner gel intenza 24h gel eyeliner 12r pure black 	0
COL name VAL loreal paris riche nudes ruj no doubts	COL name VAL loreal paris color riche free the nudes ruj no doubts	1
COL name VAL loreal paris loreal paris true match bakim yapan fondoten 5r rose sand	COL name VAL loreal paris loreal true bakim yapan fondoten rose	1
COL name VAL loraal paris seashell signature eyeliner 03 sweetbeige metallic jeans blue	COL name VAL loraal paris infaillible 24h fondaten 200 golden sand	0
COL name VAL loreal paris loreal color riche lipstick 214 violet saturn	COL name VAL loreal paris loreal paris color riche ruj 214 violet saturne pembe	1
COL name VAL loreal paris true match pudra n4 beige	COL name VAL loreal paris true pudra n4 beige	1
COL name VAL loreal paris brow artist plump and set dolgun gorunum veren kas sa	COL name VAL loreal paris brow artist plumpandset renkli kas sabitleyici maskara 108	1
COL name VAL loreal paris likit mat ruj les macarons ultra matte liquid lipstick 836 infinite va	COL name VAL loreal paris likit mat ruj les macarons matte liquid 836 va	1
COL name VAL loreal paris ruj no 238	COL name VAL loreal paris color riche ruj 238 orange after party	1
COL name VAL loraal paris superliner cyan lacquer waterproof eyeliner koyu yesil sari	COL name VAL loreal paris loreal color riche lipstick 214 violet saturn	0
COL name VAL loreal paris intense black ekstra 	COL name VAL loreal paris lash paradise intense black ekstra siyah maskara 	1
COL name VAL loreal paris color riche safari woman mat ruj 648 glamazone	COL name VAL loreal paris color safari ruj	1
COL name VAL loreal paris loreal paris true match bakam yapan fondaten 4n beige	COL name VAL loraal paris infaillible 24h fondaten 9ml beige dore	0
COL name VAL loreal paris gold mirage eye	COL name VAL loreal paris gold mirage tigers eye	1
COL name VAL loraal paris volumissime royale x10 siyah maskara	COL name VAL loreal paris loraal paris true match bakam yapan fondaten 323 golden chestnut	0
COL name VAL paris infaillible goz kalemi 314 forever	COL name VAL loreal paris infaillible 24h goz kalemi 314 forever blue	1
COL name VAL loreal paris unbelieva brow uzun sure kalici seffaf kas maskarasi	COL name VAL loreal paris loreal paris unbelieva brow uzun sure kalici seffaf kas maskarasi	1
COL name VAL loraal paris bonjour nudista aydanlak veren renkli nemlendirici 04 medium dark koyu ton	COL name VAL loreal paris anfaillible eye liner 312 stay blue	0
COL name VAL loraal paris mega volume collagene 24h siyah maskara	COL name VAL loreal paris loraal paris true match bakam yapan fondaten 12d beage	0
COL name VAL loreal paris les macarons likit mat ruj 830 blackcurrant crush	COL name VAL loreal botanicals loreal paris longwear lip liner 001 highlight on point	0
COL name VAL loraal paris xmas glitter eye nocolor dce sunny land lights	COL name VAL loreal paris infaillible dudak kalemi 207 wuthering purple x2	0
COL name VAL loreal paris pudra true match powder 2n vanilla	COL name VAL loreal paris true match pudra c3 rose beige	1
COL name VAL loreal paris les macarons likit mat ruj 826 mademoiselle mango	COL name VAL loreal paris les macarons ultra matte likit ruj 826 mademoise	1
COL name VAL loraal paris brow artist xpert no 108 warm brunette	COL name VAL loraal paris infaillible 24h matte cover ya14ksek kapataca fondaten 34 amber	0
COL name VAL loreal paris rouge signature matte likit ruj 112 achieve	COL name VAL loreal paris rouge signature likit mat ruj 112 i achieve	1
COL name VAL loreal paris true match bakam yapan fondaten 1n ivory	COL name VAL loreal paris konta14r paleti infallible sculpt contouring palette 200 mediumlight 	0
COL name VAL loreal paris loraal paris infaillible 32h fresh wear c vitaminli fondaten 200 natural linen	COL name VAL loreal paris true match bakam yapan fondaten 360 ivory fondaten	0
COL name VAL loreal paris loreal paris maskara volume million lashes kadinlar gunu ozel tasarim	COL name VAL loreal paris volume million lashes kadinlar gunu ozel tasarim	1
COL name VAL loreal paris la petite far paleti feminist	COL name VAL loreal paris goz fari paleti la petite palette feminist	1
COL name VAL loreal paris true match bakim yapan fondoten 1n ivory	COL name VAL loreal paris true match bakim 1n ivory	1
COL name VAL loreal paris kas kalemi brow artist high contour 102 cool blonde	COL name VAL paris fresh wear 140 doregolden beige 30ml	0
COL name VAL loreal paris telescopic maskara siyah	COL name VAL loreal paris siyah telescopic maskara	1
COL name VAL superliner eyeliner siyah	COL name VAL loreal paris superliner black lacquer waterproof eyeliner siyah	1
COL name VAL loreal paris million lashes mascara noir excess maskara	COL name VAL loreal paris siyah maskara volume million lashes excess	1
COL name VAL loreal paris ral infmacaronsnu ruj 834 infinite sp	COL name VAL loreal paris les macarons likit mat ruj 834 infinite spice	1
COL name VAL loreal paris les chocolats ultra matte likit ruj 842 candy man	COL name VAL loreal paris likit mat ruj les chocolats ultra matte liquid lipstick 842 candy man	1
COL name VAL loreal paris les chocolats likit mat ruj 868 cacao rush	COL name VAL loreal paris likit mat ruj les chocolats ultra matte liquid lipstick 868 cacao rush	1
COL name VAL loreal paris mat ruj color riche matte addiction 358 lava 	COL name VAL loreal paris likit mat ruj les macarons ultra matte liquid lipstick 2rc strawberry sauvage 	0
COL name VAL loreal paris pink crush infallible mega gloss 108 revolution 	COL name VAL loreal paris true match bakam yapan fondaten 1d golden ivory	0
COL name VAL loreal paris ta14m ya14ze uygulanabilir kapataca infaillible more than concealer 334 walnut	COL name VAL loreal paris loraal paris altan mirage gaz fara 120 pembe kuvars sanarla aretimazel koleksiyon	0
COL name VAL loraal paris infaillible 24h coral cards cover ya14ksek kapataca fondaten 175 sablesand	COL name VAL loraal paris true match bakam yapan fondaten 1d golden ivory	0
COL name VAL loreal paris cr khol kajal 138 blue	COL name VAL loreal paris true match kapatici 7dw golden	0
COL name VAL loraal paris les chocolats likit heart power gulkurusumavigecisli 860 nocolor ffdfbd bomb	COL name VAL loreal paris loraal paris true match bakam yapan fondaten 5n sand	0
COL name VAL loraal paris color riche les nus ruj 179 nu decadent	COL name VAL loraal paris infaillible gel crayon gaz kalemi 3r3c ive got the blue mavi	0
COL name VAL cover yuksek fondoten 90 rose porcelain	COL name VAL loreal paris infaillible 24h matte cover yuksek kapatici fondoten 90 rose porcelain	1
COL name VAL loreal paris bronze please bronzlaaytaraca pudra 03 amalfi 	COL name VAL loraal paris infaillible eye paint gaz fara 12 breathtaking brown	0
COL name VAL loreal paris le khol immaculate snow gaz kalemi 120 	COL name VAL loreal paris color riche shine addiction lipstick 834 map to nirvana 	0
COL name VAL loreal paris likit mat ruj rouge signature 103 enjoy	COL name VAL loreal paris rouge signature likit mat ruj 103 i enjoy	1
COL name VAL loreal paris mat ruj color riche matte addiction lipstick 104 pink ready to we 	COL name VAL loraal paris infaillible 24h fresh wear pudra fondaten 58 sand	0
COL name VAL loraal paris les chocolats likit mizrak uc kirmizi mm s serious green 844 shimmering champagne tooth	COL name VAL loraal paris infaillible lip paint likit ruj matte 202 king pink	0
COL name VAL loreal paris true match bakim yapan fondoten 4n beige	COL name VAL loreal paris loreal paris true match bakim yapan fondoten 4n beige	1
COL name VAL loraal paris glow mon ladies night neoncarnival dollar medium with warm olive likit aydanlataca no04 15 peachparty	COL name VAL loraal paris superstar xfiber siyah maskara	0
COL name VAL loreal paris mat ruj infallible matte rouge 008 i gotta feeling	COL name VAL loreal paris infaillible matte max ruj 008 i gotta FEELiNG	1
COL name VAL loreal paris gel intenza siyah eyeliner	COL name VAL loreal paris superliner gel intenza siyah eyeliner	1
COL name VAL loreal paris color riche les nus ruj 182 nu extreme	COL name VAL les nus ruj 182	1
COL name VAL loreal paris fondoten no 130 visible lift	COL name VAL loreal paris visible lift serum inside mat 100	1
COL name VAL loreal paris smoke x isabel marant gaz fara paleti 6gr	COL name VAL loreal paris les chocolats likit mat ruj 145 volupto choco	0
COL name VAL loraal paris les chocolats likit flustered ry siyah 858 oh my choc	COL name VAL loreal paris les macarons ultra matte likit ruj 826 mademoise	0
COL name VAL loreal paris likit rose activist bangbang likithighlighter signature 103 almondbutter 	COL name VAL loreal paris bambi eye ceylan gaz etkili maskara siyah	0
COL name VAL loreal paris deep with warm olive cherie on the cake and pl vintage gold 02 gloss shine all that jazz allak and bronzlaaytaraca pudra 	COL name VAL loraal paris mega gloss lip gloss 108 revolution fabulous	0
COL name VAL loreal paris uzun sa14re kalaca fondaten infaillible 24h you re no good wear 120 siyah 30 moon lust 	COL name VAL loraal paris infaillible 24h ultra matte prestige pudra 225 beige	0
COL name VAL loreal paris infaallable gel crayon 24h eyeliner 10 tattookirmizi	COL name VAL loraal paris color queen tekli gaz fara 16 determination	0
COL name VAL loreal paris redbrown color riche privee el cinco de mayo freida cp6 	COL name VAL loreal paris ruj infallible mega gloss 404 raspoutine me 	0
COL name VAL loreal paris infaillible 24h fresh wear pudra fondoten 220 sand	COL name VAL loreal paris infaillible 24h fresh wear pudra fondoten 220 sand	1
COL name VAL loreal paris infaillible 24h concealer pomade kapatici peach notr	COL name VAL loreal paris infaillible 24h concealer pomade kapatici 20 peach notr	1
COL name VAL loraal paris infaillible ta14m ya14ze uygulanabilir kapataca 326 vanilla	COL name VAL loreal paris likit mat ruj rouge signature 08 i achieve 	0
COL name VAL loreal paris koyu gri goz kalemi contour khol kajal 132 gris metal	COL name VAL loreal micellar makyaj suyu ve karmaya hassas ciltler icin 200 ml	0
COL name VAL loreal paris cast magic visnecurugu under the cover 02 pembe siyah desenli 	COL name VAL loraal paris color riche x balmain collection rock woman mat ruj 902 legend	0
COL name VAL loreal parismicellar makyaj temizleme normalden ve hassas ciltler icin 200 ml	COL name VAL loreal parismicellar makyaj temizleme suyu normalden ve karmaya hassas ciltler icin 200 ml	1
COL name VAL loreal paris ruj color riche lipstick 703 oud obsession	COL name VAL loreal paris color riche ruj 703 oud obsession	1
COL name VAL loreal paris telescopic carbon black maskara siyah	COL name VAL loreal paris telescopic carbon extra black maskara siyah	1
COL name VAL loraal paris color riche collection privee juliannes nude ruj	COL name VAL loreal paris brow artist skinny definer kaay kalemi 804 dark brunette 	0
COL name VAL loreal paris paradise maskara 2li matara hediyeli	COL name VAL loreal paradise 2li matara hediyeli	1
COL name VAL loreal paris siyah telescopic	COL name VAL loreal paris siyah telescopic maskara	1
COL name VAL loreal paras something spicy mavi sim color rache honey glam addactaon 908 seffaf pembe	COL name VAL loreal paris true match bakam yapan fondaten 2r rose vanilla	0
COL name VAL loreal paris rouge signature parisian sunset likit mat ruj 127revolutionize	COL name VAL loreal paris rouge signature parisian sunset likit mat ruj 127 i revolutionize	1
COL name VAL loreal paris color riche la palette nude far paleti beige	COL name VAL loreal paris goz fari paleti la palette nude 002 beige	1
COL name VAL loreal paris rouge signature likit mat ruj 117 i stand	COL name VAL loreal paris rouge signature likit mat ruj 117 i stand	1
COL name VAL loreal paris glow mon amour likit aydinlatici 02 bellini	COL name VAL loreal paris glow mon amour likit aydinlatici loving peach 02	1
COL name VAL loreal paris color riche saten bitisliruj 112 paris paris pembe	COL name VAL loreal paris color riche saten bitisli ruj 112 paris paris pembe	1
COL name VAL loreal paris true match kapatici 6dw golden honey	COL name VAL loreal paris kapatici true match concealer golden honey	1
COL name VAL loreal paris mega whos the boss	COL name VAL loreal paris mega gloss lip gloss 107 whos the boss	1
COL name VAL loraal paris m steel grey caresse 602 wn flax vf expression warm beige new	COL name VAL loreal paris loraal paris color riche plump and shine ruj	0
COL name VAL loraal paris xmas color riche lipstick lipstick burning popular nude	COL name VAL loreal paris loraal paris true match bakam yapan fondaten 5d golden sand	0
COL name VAL loreal paris likit mat ruj rouge signature 109 savor	COL name VAL loreal paris rouge signature matte likit ruj 109 savor	1
COL name VAL loraal paris bambi eye oversized ceylan gaz etkili maskara for light to medium brown hair	COL name VAL loraal paris infallible 220 sable sand fondaten	0
COL name VAL loreal paris color riche x balmain collection safari woman mat ruj 905 balmain instinct	COL name VAL loreal paris color riche safari woman mat ruj 905 balmain instinct	1
COL name VAL loreal paris color riche plump and shine ruj 108 wild fig plump	COL name VAL loreal paris loreal paris color riche plump and shine ruj	1
COL name VAL loreal paris loreal paris air volume mega easy waterproof suya dayanikli maskara siyah	COL name VAL loreal air waterproof dayanikli maskara siyah	1
COL name VAL loreal paris loreal paris true match bakim yapan fondoten 15 linen	COL name VAL loreal paris loreal match bakim yapan	1
COL name VAL loreal paris infaillible dudak kalemi 213 stripped brown kahverengi	COL name VAL loreal paris dudak kalemi infaillible lip pencil 213 stripped brown	1
COL name VAL loreal paris brow artist plumpandset renkli kas sabitleyici maskara 108	COL name VAL loreal paris brow artist plump and set dolgun gorunum veren kas sa	1
COL name VAL loreal paris true match bakam yapan fondaten 1n siyahsari	COL name VAL loraal paris infaillible eye paint gaz fara 101 eternal white	0
COL name VAL loreal paris infaillible shaping stick fondoten 160 sand	COL name VAL loreal paris stick fondoten infaillible shaping stick fondoten 160 sand	1
COL name VAL loreal paris color riche matte addiction ruj 633 moka chic nude	COL name VAL loreal paris color riche matte addiction matruj 633 moka chic	1
COL name VAL loreal paris loreal paris true match bakam yapan fondaten 4n beige	COL name VAL loraal paris infaillible shaping stick fondaten 128 natural rose	0
COL name VAL loraal paris color riche opi on collins ave sevgililer ve kadanlar ga14na14 azel tasaram	COL name VAL loreal paris bb krem bonjour nudista bb cream 04 medium dark 	0
COL name VAL loreal color 107 coconut plump	COL name VAL loreal paris color riche plump and shine ruj 107 coconut plump	1
COL name VAL loraal paris infaillible lip paint likit strawberrymilk keep it fun 201 rose mix pumpkin spice call me	COL name VAL loreal paris loraal paris infaillible ta14m ya14ze uygulanabilir kapataca 321 eggshell	0
COL name VAL loreal paris true match roller n4 buff beige	COL name VAL loreal paris loreal true match rollon fondoten n4	1
COL name VAL loreal paris true match fondaten 1r1c1k ivory rose	COL name VAL loraal paris infaillible 24h fondaten 309 true beige	0
COL name VAL loreal paris lash orb berry bright peach pastel ekstra ncanlikirmizi maskara	COL name VAL loraal paris color riche free the nudes ruj no hesitation	0
COL name VAL loraal paris infaillible 24h concealer pomade kapataca 02 gs pinkrockcandy ton	COL name VAL loreal paris ruj color riche free the nudes 01 no obstacles 	0
COL name VAL loreal paris likit metalik ruj rouge signature metallic 204 i voodoo 	COL name VAL loreal paris ruj infallible mega gloss 11 you know you 	0
COL name VAL loreal paris rouge signature metallic likit ruj 205 i fascinate	COL name VAL loreal paris likit metalik ruj rouge signature metallic 205 i fascinate	1
COL name VAL suyu kuruya hassas ciltler icin	COL name VAL loreal paris loreal paris micellar makyaj temizleme suyu normalden kuruya hassas ciltler icin 200 ml	1
COL name VAL loreal paris true match bakam yapan fondaten 5d golden sand	COL name VAL loraal paris extraordinaire 129 ruby opera	0
COL name VAL loreal paris brow artist skinny definer kas kalemi 105 brunette	COL name VAL loreal paris brow artist skinny definer kas kalemi 105 brunette	1
COL name VAL loreal paris infaillible lip paint likit ruj matte 205 apocalypse red kirmizi	COL name VAL paint likit ruj matte 205	1
COL name VAL loreal paris true match bakam yapan fondaten 8d ash blue magenta shoc	COL name VAL loreal paris loreal color queen tekli gaz fara 26 stunner	0
COL name VAL loreal mat color addiction lipstick jules	COL name VAL loreal paris mat ruj color riche matte addiction lipstick 430 mon jules	1
COL name VAL loraal paris color riche ruj 134 pink panac	COL name VAL loraal paris infaillible dudak kalemi 155 red fiction karmaza	0
COL name VAL loreal paris ruj color riche shine addiction lipstick 906 girls night	COL name VAL loreal rouge 211	0
COL name VAL loreal paris infaillible ta14m ya14ze uygulanabilir kapataca 322 ivory	COL name VAL loreal paris likit mat ruj infallible lip paint matte 360052 king pink	0
COL name VAL loreal paris loraal paris unbelieva brow micro tatouage kaay kalemi 108 dark brunette	COL name VAL loreal paris color riche shine naked tans ruj 5r5c5k topless nude	0
COL name VAL loreal paris color riche rock woman mat ruj 901 rebellion 	COL name VAL loraal paris true match bakam yapan fondaten 117 golden sand	0
COL name VAL loreal paris true match kapatici 04 natural beige	COL name VAL loreal paris kapatici true match concealer 04 natural beige	1
COL name VAL paris suyu yuz temizleme fircasi	COL name VAL loreal paris micellar makyaj temizleme suyu 400 ml yuz temizleme fircasi	1
COL name VAL loreal paris ruj color riche exclusive reds jlos red	COL name VAL loreal paris color riche ruj exclusive reds jlos pure red	1
COL name VAL loreal paris loreal paris true nude serum very light	COL name VAL loreal paris loreal paris true match nude fondoten serum 05 2 very light	1
COL name VAL loreal paris infaillible 24h matte cover yuksek kapatici fondoten 135 radiant vanilla	COL name VAL loreal paris infaillible 24h matte cover yuksek kapatici fondoten	1
COL name VAL loraal paris color riche addictive coral camelliahill 430 mon jules	COL name VAL loraal paris true match bakam yapan fondaten 3n creamy beage	0
COL name VAL loraal paris infaillible blush paint palette 01 pinks	COL name VAL loreal paris allak true match le blush no 23 luminous rose 	0
COL name VAL loreal paris true match powder w7 cinnamon	COL name VAL loreal paris true match pudra n4 beige	1
COL name VAL loreal paris rouge signature lip topper dudak parlatici ruj 210 white gold	COL name VAL loreal paris parlatici ruj rouge signature lip topper 210 white gold	1
COL name VAL loreal paris ruj color riche exclusive reds evas red	COL name VAL loreal paris color riche ruj exclusive reds evas pure red	1
COL name VAL loreal paris infallible mattifying base primer	COL name VAL loreal paris makyaj bazi infaillible mattfying	1
COL name VAL loreal paris infallible mattifying base primer	COL name VAL loreal infaillible yuze uygulanabilir	0
COL name VAL loreal paris kapataca infaillible 24h concealer pomade 20 karisik pembe 	COL name VAL loreal paris ruj color riche plump and shine lipstick 104 guava plump 	0
COL name VAL loraal paris infaillible gel crayon gaz kalemi 03 browny crush kahverengi	COL name VAL loreal paris mat pudra infaillible 24h ultra matte prestige pudra 31 beige 	0
COL name VAL loreal paris loreal paris true match bakam yapan fondaten 2r rose vanilla	COL name VAL loreal paris anfaillible eye liner 321 stay blue	0
COL name VAL loreal paris loraal paris unbelieva brow uzun sa14re kalaca kaay jeli 109 first date	COL name VAL loraal paris color riche shine naked tans ruj 656 beige in the city nude	0
COL name VAL loreal paris rouge signature matte likit ruj 113 enjoy	COL name VAL loreal paris rouge signature likit mat ruj 103 i enjoy	1
COL name VAL loreal paris true match fondoten 1r1c1k ivory rose	COL name VAL loreal paris true 1r1c1k ivory rose	1
COL name VAL loreal paris likit mat ruj infaillible lip paint lacquer 101 gone with nude	COL name VAL loreal paris infaillible lip paint likit ruj lacquer 101 gone with the nude	1
COL name VAL loreal paris le khol immaculate snow goz kalemi 120	COL name VAL loreal paris contour khol goz kalemi 120 immaculate snow	1
COL name VAL loreal paris kadan m nsesame color gul agaci	COL name VAL loreal paris loraal paris color riche ruj 214 violet saturne pembe	0
COL name VAL loraal paris telescopic maskara siyah 2li	COL name VAL loreal paris kaay serumu brow asast plumo and set 34 dark brunette	0
COL name VAL loreal paris infaillible paint gel crayon eyeliner 11 vava voum violet	COL name VAL loreal paris mor eyeliner infallible gel crayon eyeliner 11 purple	1
COL name VAL loreal paris infallible waterproof gel crayon eyeliner 17 christmas day	COL name VAL loreal paris paris waterproof crayon eyeliner 17 christmas	1
COL name VAL loraal paris true match bakam yapan fondaten 75d golden chestnut	COL name VAL loreal paris loraal paris unbelieva brow micro tatouage kaay kalemi 302rc dark brunette	0
COL name VAL loreal paris infallible base primer	COL name VAL loreal paris infallible mattifying base primer	1
COL name VAL loreal paris parlataca ruj rouge signature lip topper 211 rose gold 	COL name VAL loraal paris infaillible sculpt palette konta14r paleti 110 medium dark	0
COL name VAL loreal paris ruj color riche free the nudes 05 no diktat	COL name VAL loraal paris true match kapataca 1r1c1k rose beige	0
COL name VAL loreal paris bambi eye ceylan goz etkili maskara siyah	COL name VAL loreal bambi eye ceylan etkili	1
COL name VAL loreal paris jel kaay pomada brow relentless rose pomade humour me 102 blue me away pudra seftali 	COL name VAL loreal paris true match bakam yapan fondaten 45n true beage	0
COL name VAL loreal infaillible 24h fondoten 145 rose	COL name VAL loreal paris infaillible 24h fondoten 145 rose beige	1
COL name VAL loraal paris infaillible shaping stick allak 001 sexy flush	COL name VAL loreal paris siyah smokissime superliner 400 black 	0
COL name VAL loreal paris paris woke up like this likit aydinlatici glow mon amour 01	COL name VAL loreal paris glow mon amour likit aydinlatici 01 champagne	1
COL name VAL loreal paris bambi eye ceylan gaz etkili suya dayanakla maskara siyah 	COL name VAL loreal paris true match bakam yapan fondaten 94 golden ivory	0
COL name VAL loreal paris loreal true match bakim 1n ivory	COL name VAL loreal paris loreal paris true match bakim yapan fondoten 1n ivory	1
COL name VAL loraal paris canlinar acapulco maskara	COL name VAL loreal paris kahverengi kaay kalemi brow artist designer eyebrow pencil 303 deep brown 	0
COL name VAL loreal paris color riche c toffee woman erika f honeypot 648 glamazone	COL name VAL loraal paris paradise siyah maskara	0
COL name VAL loreal paris loreal paris infaillible 24h tum yuze uygulanabilir kapatici 330 pecan	COL name VAL loreal paris paris infaillible 24h tum kapatici pecan	1
COL name VAL loreal paris likit light rose rosy peach gl science fiction bronzing summe signature 104 supervixen 	COL name VAL loreal botanicals loreal paris infallible longwear lip liner 701 stay ultraviolet	0
COL name VAL loreal paris loreal paris brow artist plump and set dolgun gorunum veren kas sabitleyici maskara 101 blonde	COL name VAL loreal paris brow artist plump andamp set dolgun gorunum veren kas sabitleyici maskara 101 blonde	1
COL name VAL loreal paris true match fondaten 1r1c1k ivory rose	COL name VAL loreal paris ruj kalem matte lap crayon 820 maple dream	0
COL name VAL loreal paris true match allik 95 rose in love	COL name VAL loreal paris allik true match le blush no 95 rose in love	1
COL name VAL loreal paris infaillible 24h matte fondoten 11 vanille	COL name VAL loreal paris infaillible 24h matte fondoten 11 vanille	1
COL name VAL loreal paris loreal paris true match bakim yapan fondoten 5r rose sand	COL name VAL loreal true 5r sand	1
COL name VAL loraal paris color riche m ballet tutu addiction bronzbej 103 mattcontour in a rush nc basecoat	COL name VAL loraal paris infaillible 24h fondaten 125 natural rose	0
COL name VAL loreal paris infaillible lip paint likit ruj matte 203 tangerine vertigo	COL name VAL loreal paris likit mat ruj infallible lip paint matte 203 tangerine vertigo	1
COL name VAL loreal paris true match prestige pudra 3d golden beige	COL name VAL loreal paris true match prestige pudra 3d golden beige	1
COL name VAL loreal paris gaz fara infallible paint eyeshadow 401 br cool almond copp 	COL name VAL loraal paris true match bakam yapan fondaten 6n honey	0
COL name VAL loreal paris infaillible resurfacing gozenek gizleyici ve puruzsuzlestirici baz	COL name VAL loreal paris makyaj bazi infaillible mattfying	1
COL name VAL loreal paris saks mavi color riche free the tenrengivekarisikmor 05 stone fox diktat	COL name VAL loreal paris loraal paris telescopic carbon black maskara siyah 8 ml	0
COL name VAL loreal fondoten foundation ml	COL name VAL loreal paris uzun sure kalici fondoten infallible 24h foundation 220 sable 30 ml	1
COL name VAL loreal paris loreal paris true match bakim yapan fondoten 2r rose vanillatrue match kapatici 2rc rose vanilla	COL name VAL paris match bakim fondoten 2r match rose	1
COL name VAL loreal paris nocolor aeb kayasa kokulu kirmizi mm maskara 	COL name VAL loreal paris loraal paris infaillible 32h fresh wear c vitaminli fondaten 145 rose beige	0
COL name VAL loreal paris tekli gaz fara color light ivory eb mono eyeshadow 17 dont stop me 	COL name VAL loreal paris ruj color riche free the nudes 06 no hesitation 	0
COL name VAL loreal paris volume million lashes balm noir maskara	COL name VAL loraal paris true match bakam yapan fondaten 4n golden sand	0
COL name VAL loraal paris fair neutral signature likit rbewtichme auburn and redheads 114 i represent	COL name VAL loreal paris true match bakam yapan fondaten 2n vanilla	0
COL name VAL loreal infaillible makyaj bazi	COL name VAL loreal paris infaillible matlastirici makyaj bazi	1
COL name VAL loraal paris les macarons likit mat ruj 820 praline de paris	COL name VAL loreal paris loreal true match foundation 256 golden sand fondaten sa14ngeri seti	0
COL name VAL loreal paris kas kalemi brow xpert 109 ebony	COL name VAL loreal paris kas kalemi brow artist xpert 109 ebony	1
COL name VAL loreal paris true match bakim yapan fondoten 1n ivory	COL name VAL loreal match bakim yapan fondoten 1n ivory	1
COL name VAL loreal paris infaillible eye paint goz fari 102 irresistible rose	COL name VAL loreal paris infaillible eye paint goz fari 102 irresistible	1
COL name VAL loraal paris cr khol kajal 138 blue	COL name VAL loreal paris les macarons ultra matte likit ruj 374 blackcurrant	0
COL name VAL loreal paris tekli gaz fara color queen mono eyeshadow 32 commander 	COL name VAL loraal paris les chocolats likit mat ruj 4n box of chocolates	0
COL name VAL loreal paris true match bakam yapan fondaten 1r rose ivory	COL name VAL loraal paris infaillible shaping stick fondaten 16 capuccino	0
COL name VAL loreal paris infaillible 24h fresh wear pudra fondoten 120 vanilla	COL name VAL loinfaillible 24h fresh wear pudra fondoten 120 vanilla	1
COL name VAL loreal paris ruj infallible sexy balm 201 wasted	COL name VAL loreal paris infaillible sexy balm ruj 201 wasted	1
COL name VAL loreal paris aydinlatici paleti 02 cool glowlionesse barbie makyaj fircasi 010	COL name VAL loreal paleti 02 cool glowlionesse barbie makyaj fircasi 010	1
COL name VAL loraal paris infaillible 24h ruj 506 red infaillible	COL name VAL loraal paris infaillible nudist eye paint 313 cocky bisque	0
COL name VAL loreal paris loreal paris unlimited siyah maskara 2li set 1 paket 1 x 2 adet	COL name VAL paris loreal paris unlimited siyah maskara 2li set 1 1 x 2 adet	1
COL name VAL loreal paris loraal paris true match bakam yapan fondaten 5n sand	COL name VAL loraal paris infaillible 24h fondaten 3r3c ambre	0
COL name VAL loreal makyaj bazi infaillible mattfying	COL name VAL loreal paris makyaj bazi infaillible mattfying	1
COL name VAL loreal paris true match bakim yapan fondoten 6d golden honey	COL name VAL loreal paris true match bakim yapan fondoten 6d golden honey	1
COL name VAL loraal paris true match bakam yapan fondaten 2n vanalla	COL name VAL loreal paris color riche x balmain ruj 6d legend kahverengi	0
COL name VAL loreal paris color riche shine addiction lipstick 470 map to nirvana tekton 	COL name VAL loreal paris telescopic carbon extra black maskara siyah	0
COL name VAL loraal paris color riche x balmain collection n medium with neutral olive woman nocolor beafb matbeyaz 901 rebellion	COL name VAL loraal paris les macarons likit mat ruj 834 infinite spice	0
COL name VAL loreal paris volume million lashes carbon black maskara siyah	COL name VAL loreal paris bambi ceylan goz etkili maskara	0
COL name VAL infaillible 24h fresh wear pudra fondaten 220 sand	COL name VAL loraal paris colour riche extraordinaire ruj 104 rose melody	0
COL name VAL loraal paris cosmic lights dollar embel auroraborealis 03 bitter brown	COL name VAL loraal paris true match bakam yapan fondaten 1n ivory	0
COL name VAL loreal paris red brick signature empowereds likit short romance coconut flakes 138 honored 	COL name VAL loreal paris kaay kalemi brow artist micro tattoo 107 cool brunette 	0
COL name VAL loraal paris infallible stay ultraviolet 701 dudak kalemi	COL name VAL loraal paris mega gloss lip gloss 8n for the ladies	0
COL name VAL loreal paris color riche ruj matte addiction 101 candy stiletto	COL name VAL loreal paris color riche matte addiction ruj 101 candy stiletto pembe	1
COL name VAL loraal paris infaillible ta14m ya14ze uygulanabilir kapataca 326 m creamy beige	COL name VAL loraal paris infaillible 24h matte fondaten 24 beige dore	0
COL name VAL loreal paris loraal paris matte royal petrol yesil maskara	COL name VAL loraal paris color riche matte addiction ruj 471 voodoo mor	0
COL name VAL loreal paris infaillible 24h matte cover yuksek kapatici fondoten 200 golden sand	COL name VAL fondoten 200 sand	1
COL name VAL loraal paris infaillible lip paint likit ruj matte 202 king pink	COL name VAL loraal paris brow artist high contour 18 cool brunette koyu kumral	0
COL name VAL loreal paris likit mat ruj les macarons ultra matte liquid lipstick 820 praline de	COL name VAL loreal paris likit mat ruj les macarons matte liquid 836 va	0
COL name VAL loreal paris loreal color queen tekli gaz fara 20 queen	COL name VAL loreal paris loraal paris infaillible 14 fresh wear c vitaminli fondaten 404 true beige	0
COL name VAL loraal paris color riche free the pastelpembe extra pulse nocolor dec doubts	COL name VAL loreal paris kapataca true match concealer golden honey 	0
COL name VAL loreal paris waterproof crayon eyeliner 07 silver06 gold	COL name VAL loreal paris color riche shine addiction lipstick 502 beauty queen ruj 	0
COL name VAL loraal paris color pembe love tekli gaz fara 22 acik pudra pembesi	COL name VAL loreal paris allak true match le blush no 105 rose pastel 	0
COL name VAL loreal paris color riche x balmain ruj 902 legend kahverengi	COL name VAL loreal paris color riche x balmain collection rock woman mat ruj 902 legend	1
COL name VAL loraal paris infaillible 24h ruj 111 permanent blush nude	COL name VAL loreal paris dudak kalemi infaillible lip pencil 04 stay ultraviolet	0
COL name VAL loreal paris true match bakam yapan fondaten 1n baz	COL name VAL loraal paris million lashes mascara noir excess maskara	0
COL name VAL loreal paris ruj color riche shine addiction lipstick 906 girls night	COL name VAL loreal paris color riche shine addiction ruj 906 girlsnight	1
COL name VAL loraal paris true match bakam yapan fondaten 5d paint it black bitter sweet	COL name VAL loraal paris infaillible 24h fondaten 145 rose beige	0
COL name VAL loreal paris paris bambi eye black ceylan maskara ekstra	COL name VAL loreal paris loreal paris bambi eye extra black ceylan goz etkili maskara ekstra siyah	1
COL name VAL loraal paris les chocolats likit mat ruj 858 oh my choc	COL name VAL loreal paris likit metalik ruj rouge signature metallic 05r i scintillate 	0
COL name VAL loreal paris likit ruj infallible lip paint lacquer 103 fuchsia wars	COL name VAL ruj paint fuchsia wars	1
COL name VAL loreal paris loraal paris true match bakam yapan fondaten 4n beage	COL name VAL loraal paris infaillible sculpt palette konta14r paleti 101w medium light	0
COL name VAL loreal paris bitter sweet eyeliner sand storm signature eyeliner 01 ink 	COL name VAL loreal paris lash paradise intense black ekstra siyah maskara	0
COL name VAL loreal paris 24 saat kalaca brightenerhoney infaillible sparklingshake 217 granit vamp 	COL name VAL loraal paris rouge signature empowereds likit mat ruj 140 desired	0
COL name VAL loreal paris siyah eyeliner infaillible gel crayon eyeliner 01 black	COL name VAL loreal paris infaillible gel crayon goz kalemi 01 back to black siyah	1
COL name VAL loreal paris loreal paris true match bakim yapan fondoten 7d golden amber	COL name VAL loreal paris true match bakim yapan fondoten 7d golden amber	1
COL name VAL loreal paris uzun sa14re kalaca fondaten infaillible 24h nocolor cfbb wear 130 true aciktanortayaaa 30 gl sapphire shine 	COL name VAL loreal paris infaillible dudak kalemi 207 wuthering purple x2	0
COL name VAL loreal paris uc etkili makyaj temizleme suyu kuru hassas ciltler 200 ml	COL name VAL loreal paris uc etkili temizleme suyu hassas 200	1
COL name VAL loreal paris ruj xmas color riche lipstick lipstick burning red	COL name VAL loreal paris mat ruj color matte addiction lipstick 633 chic nude	0
COL name VAL loreal paris true match bakim yapan fondoten 3d golden beige	COL name VAL loreal paris true match yapan fondoten golden	1
COL name VAL loraal paris rouge signature likit mat ruj 103 i enjoy	COL name VAL loraal paris brow artist high contour 244 cool blond saraayan	0
COL name VAL loreal paris ruj color riche shine addiction lipstick 643 hot irl 	COL name VAL loreal paris fondaten true match foundation 902 golden beige 200 ml 	0
COL name VAL loreal paris mat ruj color riche matte addiction 908 storm	COL name VAL loreal paris color riche matte addiction ruj 908 storm grilila	1
COL name VAL loraal paris true match bakam yapan fondaten 4n beage	COL name VAL loraal paris true match bakam yapan fondaten 2n rose vanilla	0
COL name VAL loreal paris color riche free the nudes ruj no pressure	COL name VAL loreal paris mat ruj color riche matte addiction 2rc copper clutch 	0
COL name VAL loreal paris nude ruj no 04 color riche free no cage	COL name VAL loreal paris ruj color riche free the nudes 04 no cage	1
COL name VAL loreal paris likit ruj color riche lextraordinaire lipstick 201 rose symphony	COL name VAL loreal likit ruj color riche lextraordinaire symphony	1
COL name VAL loreal paris loraal paris true match bakam yapan fondaten 5r rose sand	COL name VAL loreal paris ruj color riche free the nudes 006 no prejudice  clrchfreends	0
COL name VAL loreal paris infaillible 24h fresh wear pudra fondoten 40 cashmere	COL name VAL loreal paris siyah bambi eye oversized ceylan	0
COL name VAL loreal paris ruj lip paint metallic 303 internet 	COL name VAL loreal paris color riche intense volume matte ruj 142 coral irreverent	0
COL name VAL loreal paris infaillible 24h fondoten 220 sable	COL name VAL loreal paris uzun sure kalici fondoten infallible 24h foundation 220 sable 30 ml	1
COL name VAL loreal paris contour khol 108 portofino blue goz kalemi	COL name VAL loreal paris mavi goz kalemi contour khol portofino blue	1
COL name VAL loreal paris annabella mauveforme cherry pop lap crayon 102 ice blondae	COL name VAL loreal paris infaillible dudak kalemi 207 wuthering purple x2	0
COL name VAL loreal paris la vie en glow highlighting powder pallette cool glow aydinlatici paleti	COL name VAL loreal paris la vie en glow aydinlatici paleti cool glow soguk tonlar	1
COL name VAL loreal paris color riche plump and shine ruj 108 wild fig plump	COL name VAL color riche plump and shine 108 wild fig plump	1
COL name VAL loreal paris likit mat ruj les macarons ultra matte liquid lipstick 830 blackcurrant crush 	COL name VAL loreal paris infaillible 182 fresh wear c vitaminli fondaten 55d rose ivory	0
COL name VAL loraal paris dress red signature eyeliner 01 ink unleashia non sticky dazzle tint no sunbeam	COL name VAL loreal paris telescopic maskara siyah	0
COL name VAL loreal paris infaillible 24h matte fondoten 22 beige eclat	COL name VAL loreal paris infaillible 24h matte fondoten 22 beige eclat	1
COL name VAL loraal paris true match bakam yapan fondaten 5d y matte rose goldenmelon	COL name VAL loraal paris color riche x balmain collection couture woman mat ruj 356 confidence	0
COL name VAL loraal paris infaillible mat koyu uzum lip paint 303	COL name VAL loreal paris gaz fara infallible eyeshadow paint 204 infinite blue 	0
COL name VAL loraal paris air mega volume maskara 30 saate kadar kalaca ekstra fashion sweetie	COL name VAL loreal paris loreal paris loraal paris mascara telescopic black	0
COL name VAL loreal paris rouge signature parisian sunset likit mat ruj 128decide 	COL name VAL loraal paris brow artist xpert no 2n cool brunette	0
COL name VAL loraal paris true match bakam yapan fondaten 1r rose ivory	COL name VAL loreal paris brow artist skinny definer kaay kalemi 5 chatain 	0
COL name VAL loreal paris petrol yesili c rich mahogany darkpurple mor lap crayon 105 tapered and salty	COL name VAL loreal paris koyu kahverengi kaay kalemi brow artist shaper 04 dark brunette 	0
COL name VAL loreal paris uzun sa14re kalaca fondaten infallible 24h foundation 230 golden 30 ml 	COL name VAL loreal paris infallible stylo eyeliner 334 832 chocolate addict kahverengi eyeliner 	0
COL name VAL loreal paris ruj color riche lipstick 430 mon jules	COL name VAL loreal paris color riche ruj matte 430 mon jules	1
COL name VAL loreal paris loreal paris infaillible 32h fresh wear c vitaminli fondoten 220 sand	COL name VAL loreal paris infaillible matte yuksek fondoten rose ivory 	0
COL name VAL loreal paris bb krem orta ton skin perfection bb cream medium spf 25 50 ml	COL name VAL loreal true match pudra w1 golden ivory	0
COL name VAL loreal paris kaay maskarasa brow asast plumo and classic ruby 109 berry elixir	COL name VAL loreal paris ruj color riche free the nudes 04 no cage	0
COL name VAL loreal paris uzun sure kalici fondoten infallible 24h foundation 145 beige rose	COL name VAL loreal paris infaillible 24h fondoten 145 beige rose	1
COL name VAL loreal paris loreal paris color riche free the nudes ruj no cliche	COL name VAL loreal paris free ruj no	1
COL name VAL paris rouge signature matte likit ruj 114 represent	COL name VAL loreal paris rouge signature matte likit ruj 114 represent	1
COL name VAL loreal paris ruj color riche lipstick 238 orange after	COL name VAL loreal paris color riche ruj 238 orange after party	1
COL name VAL loreal paris likit mat ruj les macarons ultra matte liquid lipstick 834 infinite spice 	COL name VAL loreal paris tekli gaz fara color queen mono eyeshadow 30ml charmer 	0
COL name VAL loreal paris paradise maskara sevgililer ve kadinlar gunu ozel	COL name VAL loreal paris paradise maskara sevgililer ve kadinlar gunu ozel tasarim	1
COL name VAL loreal paris likit mat ruj les macarons ultra matte liquid lipstick 830 blackcurrant crush 360052	COL name VAL loreal paris les macarons likit mat ruj 830 blackcurrant crush	1
COL name VAL loreal paris ruj lip paint metallic 305 cute but	COL name VAL loreal paris infaillible metallic lip paint 305 cute but psycho	1
COL name VAL loreal paris infaillible 24h matte cover yuksek kapatici fondoten 175 sablesand	COL name VAL loreal paris infaillible matte yuksek kapatici fondoten 175 sablesand	1
COL name VAL loreal paris loreal paris true match bakim yapan fondoten 7r rose amber	COL name VAL loreal paris true match bakim yapan fondoten 7r rose amber	1
COL name VAL loreal paris chroma neon laner 21 electric zoo	COL name VAL loreal paris no 129 true mach allak	0
COL name VAL loreal paris mavi goz kalemi contour khol portofino blue	COL name VAL loreal paris goz kalemi no 108 portofino mavisi	1
COL name VAL loreal paris infaillible lip paint likit ruj matte 207 wuthering purple	COL name VAL loreal paris colorista effects balayage	1
COL name VAL loreal paris extraordinaire 204	COL name VAL loreal paris extraordinaire 204 tangerine	1
COL name VAL loreal paris bambi eye extra black ceylan gaz etkili maskara ekstra siyah	COL name VAL loreal paris infaillible 24h matte cover ya14ksek kapataca fondaten 010 radiant honey 	0
COL name VAL loreal paris tekli gaz fara color queen mono eyeshadow 24 excessive 	COL name VAL loraal paris brow artist xpert no 010 ebony	0
COL name VAL loreal paris true match fondoten w7d7 golden amber	COL name VAL loreal paris fondoten true match fondoten no7d7w golden amber	1
COL name VAL loreal paris latmoraal paris uzun sa14re kalaca kaay jeli unbelieva brow 109 ebony	COL name VAL loreal paris allak true match le blush no 3r sandlewood 	0
COL name VAL loreal paris les macarons ultra matte likit ruj 832 strawberry	COL name VAL loreal paris likit mat ruj les macarons ultra matte liquid lipstick 832 strawberry sauvage	1
COL name VAL loraal paris les macarons likit n sand redpassion 832 r mli sauvage	COL name VAL loreal paris true match bakam yapan fondaten 5n sand fondaten	0
COL name VAL loreal paris loreal telescopic maskara gaz makyaj seti	COL name VAL loraal paris infaillible ta14m ya14ze uygulanabilir kapataca 2r2c fawn	0
COL name VAL loreal paris true match bakam yapan fondaten 1d golden ivory	COL name VAL loreal paris true match bakam yapan fondaten 6d golden almond	0
COL name VAL loreal paris light medium with warm neutral color riche plump and shine lipstick 104 moyen medium plump 	COL name VAL loraal paris xmas color riche lipstick lipstick close at night	0
COL name VAL loraal paris color riche maroon 335 carmin pinky punch germain	COL name VAL loraal paris infaillible ta14m ya14ze uygulanabilir kapataca 332 amber	0
COL name VAL loreal paris rouge signature empowereds likit mat ruj 140 desired	COL name VAL loreal paris loreal paris rouge signature empowereds likit mat ruj 140 desired	1
COL name VAL loreal paris ruj color riche privee nudes doutzens nude	COL name VAL loreal paris ruj color riche collection privee doutzens nude	1
COL name VAL tekli gaz fara color sari desensiz mono eyeshadow 05 nocolor facb	COL name VAL loreal paris true match fondaten 2n vanilla	0
COL name VAL loreal paris paris stick fondoten 190 beige dore	COL name VAL loreal paris infaillible shaping stick fondoten 190 beige dore	1
COL name VAL loreal paris true match bakim yapan fondoten 8n cappucino	COL name VAL loreal paris true match bakim yapan fondoten 8n cappucino	1
COL name VAL loraal paris les macarons likit mat ruj 830 blackcurrant crush	COL name VAL loreal paris likit mat ruj les chocolats ultra matte liquid lipstick 052 oh my choc 	0
COL name VAL loreal paris softheart color riche free the festiveburgundy 09 lirenk judgment	COL name VAL loraal paris infaillible ta14m ya14ze uygulanabilir kapataca 321 eggshell	0
COL name VAL loreal paris rouge signature matte likit ruj 113 enjoy	COL name VAL loreal paris rouge signature likit	1
COL name VAL loreal paris infaillible metallic eye paint 401 metallic copper	COL name VAL loreal paris goz fari infallible paint eyeshadow 401 metal copp	1
COL name VAL loreal paris siyah bambi eye oversized ceylan gaz etkili maskara	COL name VAL loreal paris color riche ruj matte addiction 114 cherry front	0
COL name VAL loraal paris infaillible ta14m ya14ze uygulanabilir kapataca 338 nude delight	COL name VAL loreal paris infaillable lipgloss 309 sayonara sunset	0
COL name VAL loreal botanicals loreal paris infallible longwear lip liner 105 red fiction	COL name VAL botanicals loreal paris infallible longwear liner 105 red fiction	1
COL name VAL loreal paris loreal paris true match nude fondoten serum 052 very light	COL name VAL loreal paris true match nude serum fondoten 052 very light	1
COL name VAL loreal paris loraal paris color riche shine perfect rose tans arousing orange 656 n neutre hale in the city power lily	COL name VAL loraal paris superliner perfect slim siyah eyeliner	0
COL name VAL ekstra siyah likit superliner tattoo liner	COL name VAL loreal paris ekstra siyah likit eyeliner superliner tattoo signature liner	1
COL name VAL loraal paris infaillible 24h sedefli fume cover ya14ksek kapataca fondaten 90 biscuit and coral cherry dessert	COL name VAL loreal paris les chocolats ultra matte likit ruj 868 cacao crush	0
COL name VAL loreal paris stick fondaten infaillible longwear shaping stick foundation 220 sl chocolate 9 parlakseftali 	COL name VAL loreal paris ceylan gaz etkili maskara siyah maybelline new york kajal gaz kalem	0
COL name VAL loreal paris infaillible 24h ruj 121 flawless fuschia	COL name VAL loreal paris loreal paris infaillible 24h ruj 121 flawless fuschia	1
COL name VAL loreal paris true match bakam yapan fondaten 2d beaux arts film noir	COL name VAL loraal paris glow mon amour likit aydanlataca 03 bronze in love	0
COL name VAL loreal paris color richa ultra matte mat ruj no doubts	COL name VAL loreal paris color riche free the nudes ruj no doubts	1
COL name VAL loraal paris superliner altinsarisisimli lacquer waterproof eyeliner tatli seftali	COL name VAL loreal paris infaillible 32h fresh wear c vitaminli fondaten 60 rose ivory	0
COL name VAL loraal paris true match bakam yapan fondaten 5d golden sand	COL name VAL loreal paris les macarons ultra matte likit ruj 338 framboise	0
COL name VAL loreal paris color riche matte addiction ruj 655 copper clutch kahverengi	COL name VAL loreal paris color riche matte addiction ruj 655 copper clutch	1
COL name VAL loreal paris color riche ruj matte 430 mon jules	COL name VAL loreal paris ruj color riche lipstick 430 mon jules	1
COL name VAL loreal paris true match prestige pudra 2n vanilla	COL name VAL loreal paris pudra true match prestige powder 2n vanilla	1
COL name VAL loreal paris aydinlatici palet en glow warm glow air volume maskara seti	COL name VAL loreal paris aydinlatici palet en glow warm glow air volume	1
COL name VAL loreal paris infaillible 24h matte fondoten 24 beige dore	COL name VAL loreal paris infaillible 24h matte fondoten 24 beige dore	1
COL name VAL loraal paris infaillible 24h gaz kalemi 300 satin red sedefli addiction	COL name VAL loreal paris likit mat ruj les macarons ultra matte liquid lipstick 834 infinite spice 	0
COL name VAL loreal paris color riche matte addiction ruj 633 moka chic nude	COL name VAL loreal paris mat ruj color riche matte addiction lipstick 633 moka Chic nude	1
COL name VAL loreal paris true match bakim yapan fondoten 45n true beige	COL name VAL paris match bakim true	1
COL name VAL loraal paris infaillible lip paint likit dusk to daw map to nirvana 205 apocalypse ndramaticred karmaza	COL name VAL loreal paris true match bakam yapan fondaten 8r nut brown	0
COL name VAL loreal paris true match bakam yapan fondaten 2r rose	COL name VAL loreal paris loreal infaillible more than concealer 842 ivory ivore 43	0
COL name VAL loraal paris true match bakam yapan fondaten 75d desert sun single serving	COL name VAL loraal paris true match kapataca 4n beige	0
COL name VAL loreal paris bambi eye false lash ceylan gaz etkili ekstra siyah maskara	COL name VAL loreal paris 355r saat kalaca ruj infaillible 13 	0
COL name VAL loreal paras ruj lap paant metallac 306 lolata	COL name VAL loreal paris rouge signature likit mat ruj 245 i am worth it	0
COL name VAL loreal paris brow artist high contour 103 warm blond acik sarisin	COL name VAL loreal paris kas kalemi brow artist high contour 103 warm blonde	1
COL name VAL loraal paris infaillible 24h gaz kalemi 312 dazzlingplum orta ton	COL name VAL loreal paris dudak kalemi infaillible lip pencil 06 golden woman 	0
COL name VAL loraal paris true match bakam yapan fondaten 5d darkbrunette such a tulle	COL name VAL loraal paris true match bakam yapan fondaten 5r rose sand	0
COL name VAL loreal paris fondaten infallible golden bej 	COL name VAL loreal paris likit ruj no 2n	0
COL name VAL loreal paris paradise extatic siyah maskara	COL name VAL loreal paris paradise extatic siyah maskara	1
COL name VAL loreal paris loreal paris true match nude fondoten serum 2 3 light	COL name VAL true fondoten 2 light	1
COL name VAL loraal paris les chocolats likit aruba acik sari nude 856 70 lantern light	COL name VAL loraal paris infaillible magic essence drops likit makyaj baza	0
COL name VAL loreal paris lash telescopic fiber maskara	COL name VAL loreal paris paris false lash telescopic fiber maskara	1
COL name VAL loreal paris ruj color riche free the nudes 01 no obstacles	COL name VAL loreal paris cr ultra matte ruj no 01 obstacle	1
COL name VAL loreal paris false lash wings mascara intenza 7 ml siyah	COL name VAL loreal paris siyah maskara false lash butterfly effect intenza	1
COL name VAL loraal paris rouge signature parisian sunset likit mat ruj 132 i radiate	COL name VAL loraal paris les macarons likit mat ruj 350 mademoiselle mango	0
COL name VAL loreal paris loraal paris unlimited kaldarma etkili siyah maskara 74 ml	COL name VAL loreal paris ruj lip paint metallic 141 lolita 	0
COL name VAL loreal paris kadin pembe allik wake up and glow blush 03 melon dollar baby	COL name VAL loreal paris melon dollar embel blush 03 watermelon	1
COL name VAL loreal paris dudak kalemi color riche crayon liner 285 boudoirpink universal beige warm gold 	COL name VAL loreal paris gaz fara infallible eyeshadow paint 102 irresistible 	0
COL name VAL loraal paris telescopic maskara crimsoncream 2li	COL name VAL loreal paris true match bakam yapan fondaten 45n true beage	0
COL name VAL loreal paris goz fari infaillible paint nude eyeshadow 306 nudist	COL name VAL loreal paris infaillible nudist eye paint 306-nudist	1
COL name VAL loreal paris loreal paris volume million lashes balm brown kahverengi maskara	COL name VAL loreal paris 2 saat kalaca kalem no 10	0
COL name VAL loreal paris loraal paris true match bakam yapan fondaten 75d clightwithcoolpeachundertones feral brown	COL name VAL loreal paris color riche shine ruj	0
COL name VAL loreal paris infaillible lip paint likit ruj matte 205 apocalypse red kirmizi	COL name VAL loreal paris infaillible lip paint likit ruj matte 205 apocalypse red	1
COL name VAL loraal paris unlimited kaldarma etkili siyah maskara 74 ml	COL name VAL loreal paris infaillible 24h matte cover ya14ksek kapataca fondaten 129 rose porcelain 	0
COL name VAL loraal paris rouge signature likit mat ruj 109 i savor	COL name VAL loreal paris dudak kalemi infaillible lip pencil 203 stay ultraviolet	0
COL name VAL loreal paris true match pudra c1 rose ivory	COL name VAL loreal paris pudra true match powder c1 rose ivory	1
COL name VAL loreal paris pudra true match powder n4 beige	COL name VAL loreal paris true match pudra n4 beige	1
COL name VAL loreal paras morethemehr ier lap paant metallac 306 lolata	COL name VAL loreal paris brilliant signature plump in gloss ruj seti 412 i heighten and 402 i soar and aanta	0
COL name VAL loraal paris infaillible matlaaytaraca nude blush baza	COL name VAL loreal paris likit mat ruj rouge signature	0
COL name VAL loreal paris kahverengi eyeliner infaillible gel crayon eyeliner 05 cooper	COL name VAL loreal paris infaillible gel crayon goz kalemi 05 super cooper bakir	1
COL name VAL loreal paris infaillible 24h matte cover yuksek kapatici fondoten 200 golden sand	COL name VAL loreal paris infaillible 24h matte cover yuksek fondoten 200 golden sand	1
COL name VAL loreal paris color riche ruj privee jlos nude	COL name VAL loreal paris color jlos nude	1
COL name VAL paris infaillible 24h red kirmizi	COL name VAL loreal paris infaillible 24h ruj 506 red kirmizi	1
COL name VAL loreal paris true match bakim yapan fondoten 4d golden natural	COL name VAL loreal paris true match bakim yapan fondoten 4d golden	1
COL name VAL loreal paris suya dayanikli siyah maskara unlimited very different waterproof mascara black	COL name VAL loreal loreal paris yapan beige	0
COL name VAL loreal paris true match bakam yapan fondaten 4n neon blazing fire ml	COL name VAL loreal paris infaillible 24 fresh wear fondaten 140 beige doregolden beige 30ml	0
COL name VAL loreal paris ruj color riche free the nudes 02 no cliche	COL name VAL loreal ruj color free the no	1
COL name VAL loreal paris color riche ruj 238 orange after party	COL name VAL loreal paris ruj color riche lipstick 238 orange after	1
COL name VAL loreal paris siyah maskara false lash architect 4d mascara black 	COL name VAL loreal paris stick fondaten infaillible longwear shaping stick foundation 03 caramel 3w g 	0
COL name VAL loreal paris infaillible 24 fresh wear fondoten 140 beige doregolden beige 30ml	COL name VAL paris fresh wear 140 doregolden beige 30ml	1
COL name VAL loreal paris loreal paris makyaj allik fircasi	COL name VAL loreal paris makyaj fircasiallik fircasi	1
COL name VAL loreal paris color richa ultra matte mat ruj no 6 hesitation	COL name VAL loreal paris kaay kalemi brow artist high contour 2r2c cool brown 	0
COL name VAL loraal paris true match allak 105 acikyesil acikmavi patlican acik kahve	COL name VAL loreal paris true match bakam yapan fondaten 4n beage	0
COL name VAL loreal paris color riche ruj no 143 pink pigalle	COL name VAL loreal paris uzun sa14re kalaca fondaten infaillible 24h fresh wear 101 vanilla 801 ml 	0
COL name VAL loraal paris pastel signature eyeliner 03 midnight red velvet cake	COL name VAL loreal paris les macarons ultra matte likit ruj 826 mademoise	0
COL name VAL loreal paris color riche shine nberrystain	COL name VAL loraal paris true match bakam yapan fondaten 5d golden sand	0
COL name VAL loreal paris true match bakim yapan fondoten 6n honey	COL name VAL loreal paris true match fondoten 6n mielhoney	1
COL name VAL loreal paris loreal paris infaillible 32h fresh wear c vitaminli fondoten 200 natural linen	COL name VAL loreal paris infaillible 24h fondoten 200 golden sand	1
COL name VAL loreal paris siyah eyeliner superliner blackbuster	COL name VAL loreal paris superliner blackbuster eyeliner	1
COL name VAL loreal paris color riche free the nudes ruj no pressure	COL name VAL loreal paris color riche free the no pressure	1
COL name VAL loreal paris ruj color riche free the nudes 06 no hesitation	COL name VAL loreal paris color riche free the nudes ruj no hesitation	1
COL name VAL loreal paris siyah maskara volume million lashes excess	COL name VAL loreal paris million lashes mascara noir excess maskara	1
COL name VAL loreal paris true match bakam yapan fondaten 2d golden almond	COL name VAL loraal paris infaillible 24h matte cover ya14ksek kapataca fondaten 301 rose porcelain	0
COL name VAL loreal paris rouge signature likit mat ruj 106 i speak up	COL name VAL loreal paris rouge signature likit mat ruj 106 i speak up	1
COL name VAL loraal paris brow artist skinny definer kaay kalemi 104 chatain	COL name VAL loraal paris color riche ruj matte 332 mon jules	0
COL name VAL loraal paris true match bakam yapan fondaten 1d mavi lila metalgri	COL name VAL loreal paris loraal paris lash paradise intense black ekstra siyah maskara	0
COL name VAL loreal paris true match bakim yapan fondoten 3d golden beige	COL name VAL loreal paris fondoten true match no3c3r rose beige	1
COL name VAL loreal paris unlimited very different waterproof suya dayanikli maskara	COL name VAL loreal paris suya dayanikli siyah maskara unlimited very different waterproof mascara black	1
COL name VAL loreal paris brow artist skinny definer kas kalemi 103 dark blonde	COL name VAL loreal paris brow artist skinny definer kas kalemi 103 dark blonde	1
COL name VAL loraal paris glow mon amour likit aydanlataca 03 bronze in love	COL name VAL loreal paris infaillible 24h matte cover ya14ksek kapataca fondaten 20 rose ivory 	0
COL name VAL loreal paris loraal paris bambi eye extra black ceylan gaz etkili maskara ekstra siyah	COL name VAL loraal paris infaillible dudak kalemi 430 hollywood beige nude	0
COL name VAL loreal paris miss baby roll siyah maskara	COL name VAL loreal paris paris mega volume missbaby roll maskara black	1
COL name VAL tekli gaz fara color queen mono eyeshadow 05 ruler	COL name VAL loraal paris true match bakam yapan fondaten 360052 golden beige	0
COL name VAL loraal paris color riche free the pinksand light with warm yellow it s vintage obstacles	COL name VAL loreal paris false lash telescopic fiber maskara 9ml	0
COL name VAL loreal paris color riche matte addiction ruj 654 bronze sautoir kahverengi	COL name VAL loreal paris mat ruj color riche matte addiction 654 bronze sautoir	1
COL name VAL loraal paris color riche la vie en rose ruj naomis pink	COL name VAL loreal paris tekli gaz fara color queen mono eyeshadow 241 influence 	0
COL name VAL loreal paris infaillible gel crayon goz kalemi 03 browny crush kahverengi	COL name VAL loreal paris kahverengi eyeliner infaillible gel crayon eyeliner 03 brown	1
COL name VAL loreal paris volume million lashes so couture noir black maskara 95 ml	COL name VAL loraal paris true match bakam yapan fondaten 208 golden almond	0
COL name VAL loreal paris glam shine balmy gloss 912	COL name VAL loreal paris ruj glam shine balmy gloss 912	1
COL name VAL loreal paris loreal paris makyaj allik fircasi	COL name VAL loreal makyaj allik fircasi	1
COL name VAL loreal paris color queen tekli gaz fara 29 ruthless	COL name VAL loraal paris glow mon amour likit aydanlataca 1r bellini	0
COL name VAL loreal bambi eye extra black ceylan etkili maskara siyah	COL name VAL loreal paris bambi eye extra black ceylan goz etkili maskara ekstra siyah	1
COL name VAL loreal paris kas kalemi brow artist high contour 107 cool brown	COL name VAL loreal paris brow artist high contour 107 cool brunette koyu kumral	1
COL name VAL loreal paris lash sensational yelpaze etkili maskara burgundy brown	COL name VAL loraal paris infaillible 24h gaz kalemi 175 chocolate addiction	0
COL name VAL loreal paris likit nocolor fcdd nocolor dbfe les chocolats ultra sell out liquid lipstick 844 metalik leylak tooth 	COL name VAL loreal paris true match bakam yapan fondaten 1d golden ivory	0
COL name VAL loraal paris brow nocolor dcfe shaper kaay kalemi 04 beige with gold batik pembe desenli	COL name VAL loraal paris anfaillible eye liner 306 stay blue	0
COL name VAL loraal paris color riche plump and shine ruj 107 coconut plump	COL name VAL loraal paris le liner signature gaz kalemi 828 rouge noir angora	0
COL name VAL loraal paris color riche matte addiction ruj 654 bronze sautoir kahverengi	COL name VAL loreal paris mavi eyeliner infaillible gel crayon eyeliner 100 blue 	0
COL name VAL loreal paris les macarons ultra matte likit ruj 828 framboise	COL name VAL loreal paris les macarons likit mat ruj 828 framboise frenzy	1
COL name VAL loreal paris lash chocolate fondue midnightstar d silver ekstra that s peachy maskara	COL name VAL loreal paris loraal paris infaillible 32h fresh wear c vitaminli fondaten 145 rose beige	0
COL name VAL loreal paris color riche plump and shine ruj 104 guava plump	COL name VAL loreal paris ruj color riche plump and shine lipstick 104 guava plump	1
COL name VAL loreal loreal ceylan goz etkili eks maskara	COL name VAL loreal paris loreal paris bambi eye ceylan goz etkili maskara eks siyah maskara	1
COL name VAL loreal paris infallible super grip primer	COL name VAL loreal paris infaillible super grip guclu tutus saglayan makyaj bazi	1
COL name VAL loraal paris infaillible ta14m ya14ze uygulanabilir kapataca 323 fawn	COL name VAL loreal paris ruj color riche free the nudes 852 no cage	0
COL name VAL loraal paris color riche free the nudes ruj no hesitation	COL name VAL loreal paris rouge signature matte likit ruj 285 dont	0
COL name VAL loreal paris loreal paris true match bakim yapan fondoten 5r rose sand	COL name VAL paris paris true match fondoten 5r rose sand	1
COL name VAL loraal paris infallible waterproof gel crayon eyeliner 16 intutive dark life	COL name VAL loraal paris infaillible 24h fondaten 145 rose beige	0
COL name VAL paris wings midnight maskara	COL name VAL loreal paris wings midnight siyah maskara	1
COL name VAL loreal signature empowereds likit mat 136 armored	COL name VAL loreal paris rouge signature empowereds likit mat ruj 136 armored	1
COL name VAL loreal paris true match prestige powder 2n vanilla pudra 	COL name VAL loraal paris les chocolats likit mat ruj 864 cacao rush	0
COL name VAL loreal paris stick fondaten infaillible longwear shaping stick foundation 210 capuccino 9 n medium 	COL name VAL loreal paris micellar makyaj temizleme suyu normalden ve karmaya hassas ciltler iain	0
COL name VAL loraal paris superliner smokissime eyeliner black	COL name VAL loreal paris likit aydanlataca glow mon amour droplet highlight 136 bronze in love 	0
COL name VAL loreal paris infaillible sexy balm ruj 108 whaaat	COL name VAL loreal paris ruj infallible sexy balm 108 whaaat	1
COL name VAL loreal paris brow artist micro tattoo 105 brunette kumral	COL name VAL loreal paris kas kalemi brow artist micro tattoo 105 brunette	1
COL name VAL loraal paris infaillible 24h naive cover ya14ksek kapataca fondaten 115 drop dead red rusty luster	COL name VAL loreal paris macellar	0
COL name VAL loreal paris infaillible 24h matte cover yuksek kapatici fondoten 290 golden amber	COL name VAL loreal paris infaillible 24h matte cover yuksek kapatici fondoten 290 golden amber	1
COL name VAL loreal paris nude magique cc krem yorgun cilt karsiti anti fatigue	COL name VAL loreal paris yorgunluk izleri karsiti cc krem nude magique 30 ml	1
COL name VAL loreal paris color riche shine jl plum it up tans nocolor acdcb 658 topless fcviolet dream	COL name VAL loreal paris dudak kalemi infaillible lip pencil 207 wuthering purple 	0
COL name VAL loreal paris infaillible resurfacing gazenek gizleyici ve pa14ra14zsa14zleaytirici makyaj baza	COL name VAL loraal paris mega gloss lip gloss 201 whos the boss	0
COL name VAL loreal paris infaillible eye paint goz fari khaki	COL name VAL loreal paris infaillible eye paint goz fari 202 keep on khaki	1
COL name VAL loreal les macarons likit ruj 826 mademoiselle mango	COL name VAL loreal paris les macarons likit mat ruj 826 mademoiselle mango	1
COL name VAL loreal paris ruj color riche lipstick 430 mon jules 	COL name VAL loraal paris anfaillible eye liner 130 stay blue	0
COL name VAL loraal paris rouge signature parisian sunset likit mat ruj 130 i amaze	COL name VAL loraal paris infaillible eye paint gaz fara 703 eternal white	0
COL name VAL loreal paris infaillible 24h roseatepink wear pudra fondaten 180 coffeebrown nocolor dcefce	COL name VAL loraal paris true match fondaten c7 ambre rose	0
COL name VAL loreal paris infaillible tum yuze uygulanabilir kapatici 330 pecan	COL name VAL loreal paris yuze uygulanabilir kapatici	1
COL name VAL loreal paris infaillible 24h fondoten 300 amber	COL name VAL loreal paris loreal paris infaillible 24h fondoten 300 amber	1
COL name VAL loreal paris infaillible 24h concealer pomade kapatici 02 medium koyu ton	COL name VAL loreal paris paris infaillible 24h concealer pomade kapatici 02 medium	1
COL name VAL loreal paris natural wilderness lattelip seti	COL name VAL loreal paris dudak kalemi infaillible lip pencil 701 stay ultraviolet	0
COL name VAL loreal paris loraal paris infaillible ta14m ya14ze uygulanabilir kapataca 338 honey	COL name VAL loreal paris super liner gelmatic 75d deep violet mor gaz kalemi	0
COL name VAL loreal paris true match bakam yapan fondaten 1n ivory	COL name VAL loraal paris true match bakam yapan fondaten 824 vanilla	0
COL name VAL loreal paris x isabel marant lipstick limited edition 01	COL name VAL loreal paris loraal paris color riche shine naked tans ruj 5i beige in the city nude	0
COL name VAL loreal paris dudak kalemi infaillible lip pencil 701 stay farmasinudenailcolorschocolatesouffle	COL name VAL loreal paris infallible 24h concealer 328 linen	0
COL name VAL loreal paris suya dayanakla jl maskara unlimited very different waterproof mascara my etern 	COL name VAL loreal paris true match bakam yapan fondaten 2r rose	0
COL name VAL loreal paris paradise makyaj seti	COL name VAL loreal paris paradise makyaj seti	1
COL name VAL loreal paris infaillible 24h fondoten 140 beige dore	COL name VAL loreal paris uzun sure kalici fondoten infallible 24h foundation 140 beige dore 30 ml	1
COL name VAL loraal paris color riche intense volume matte ruj 103 blush audace	COL name VAL loreal paris true match bakam yapan fondaten 155 beige	0
COL name VAL loreal paris dudak kalemi infaillible lip pencil 105 trueivory fiction	COL name VAL loreal paris dudak kalemi color riche crayon liner 302 bois de rose 	0
COL name VAL loreal paris ruj color riche lipstick 364 16 place ven	COL name VAL loreal paris color riche ruj 364 16 place vendome	1
COL name VAL loreal paris likit ruj color riche lextraordinaire lipstick 401 fuchia drama	COL name VAL loreal paris colour riche extraordinaire ruj101 rose melody	1
COL name VAL loreal paris les macarons ultra rouge cherie likit ligthbrown 828 framboise	COL name VAL loraal paris rouge signature likit mat ruj 115 i am worth it	0
COL name VAL loreal paris pudra true match powder 2n lattebrown 	COL name VAL loraal paris color riche matte addiction ruj 655 copper clutch kahverengi	0
COL name VAL loreal paris makyaj bazi infaillible mattfying	COL name VAL loreal paris infallible mattifying base primer	1
COL name VAL loreal paris loraal paris nocolor dba barbie pink maskara	COL name VAL loreal paris infaillible resurfacing gazenek gizleyici ve pa14ra14zsa14zleaytirici baz	0
COL name VAL loreal paris true match bakim yapan fondoten 1d golden ivory	COL name VAL loreal paris true match bakim yapan fondoten 1d golden ivory	1
COL name VAL loreal paris siyah eyeliner ultra precision superliner 01 	COL name VAL loreal paris kapataca true match concealer 02 rose vanilla 	0
COL name VAL loraal paris air mega volume maskara 30 saate kadar kalaca ekstra siyah	COL name VAL loreal paris le liner signature mavi gaz kalemi 241	0
COL name VAL loreal paris siyah eyeliner smokissime superliner 100 black	COL name VAL loreal paris superliner smokissime eyeliner	1
COL name VAL paris color riche matte addiction ruj 655 copper clutch kahverengi	COL name VAL loreal paris color riche matte addiction ruj 655 copper clutch kahverengi	1
COL name VAL loreal paris loreal paris infaillible 24h fondoten 230 radiant honey	COL name VAL loreal paris infaillible 24h fondoten 230 radiant honey	1
COL name VAL loreal paris loreal paris true match bakim yapan fondoten 5n sand	COL name VAL loreal paris true match bakim yapan fondoten 5n sand	1
COL name VAL loreal paris superliner smokissime eyeliner black	COL name VAL loreal paris siyah eyeliner smokissime superliner 100 black	1
COL name VAL loreal paris color riche safari woman mat ruj 648 glamazone	COL name VAL loreal paris bakim 1r ml	0
COL name VAL loreal paris kas kalemi brow artist high contour 103 warm blonde	COL name VAL loreal paris brow artist high contour 103 warm blond acik sarisin	1
COL name VAL loreal paris infaillible 24h matte cover yuksek kapatici fondoten 300 amber	COL name VAL loreal paris infaillible 24h matte cover yuksek kapatici fondoten 300 amber	1
COL name VAL loreal paris kahverengi eyeliner infaillible gel crayon eyeliner 03 brown	COL name VAL loreal paris infaillible gel crayon goz kalemi 03 browny crush kahverengi	1
COL name VAL loreal paris loraal paris color riche plump and shine ruj	COL name VAL loreal paris true match bakam yapan fondaten 02 golden ivory	0
COL name VAL loreal paris loreal paris infaillible 24h tum yuze uygulanabilir kapatici 326 vanilla	COL name VAL loreal loreal infaillible tum kapatici 326	1
COL name VAL loreal paris loreal paris telescopic carbon siyah maskara maskara	COL name VAL loreal paris telescopic maskara	1
COL name VAL loreal paris true match bakam yapan fondaten 2r rose	COL name VAL loreal paris stick allak infaillible shaping stick allak 5i sexy flush 	0
COL name VAL loreal paris koyu gri goz kalemi contour khol kajal 132 gris metal	COL name VAL loreal paris contour khol goz kalemi 132 gris metal	1
COL name VAL loreal paris kaay kalemi brow nude blush high contour 107 brightfuschia acik nude kahve 	COL name VAL loreal paris mat ruj infallible matte rouge 007 say my name 	0
COL name VAL loreal paris kapataca true match concealer 3rc douro mat sari retro ruby 	COL name VAL loreal paris loraal paris true match bakam yapan fondaten 4n beage	0
COL name VAL loreal paris true match fondation spf17 amber 30 ml	COL name VAL loreal paris true mach yagsiz fondoten n7 30 ml	1
COL name VAL loreal paris loreal paris true match bakim yapan fondoten 5d golden sand	COL name VAL loreal loreal paris match bakim yapan fondoten 5d golden sand	1
COL name VAL loraal paris infaillible 24h murdum kahve cover ya14ksek kapataca fondaten 90 grs cashmere rose	COL name VAL loreal paris emotions of nu allak far paleti sky maskara seti	0
COL name VAL loreal paris lash paradise intense black ekstra siyah maskara	COL name VAL loraal paris infaillible 24h fondaten 830 true beige	0
COL name VAL loreal paris kaay kalemi brow pure white high contour 107 box of chocolates sarifrenc 	COL name VAL loreal paris infaillible more than concealer 323 fawn ta14m ya14ze uygulanabilir kapataca	0
COL name VAL loreal paris medium caramel color riche free the iguacu 04 crystalnude cage	COL name VAL loraal paris telescopic maskara siyah 1 paket	0
COL name VAL loreal paris infallible mattifying base mallow reflection	COL name VAL loreal paris ruj color riche free the nudes 08 no lies	0
COL name VAL loreal paris ruj color riche privee nudes jlos nude	COL name VAL loreal paris color riche ruj privee jlos nude	1
COL name VAL loreal paris likit chocolataulait rose taupe craze bordo geyik signature 113 i dont	COL name VAL loreal botanicals loreal paris superliner silkissime 03 moonlight blue	0
COL name VAL loraal paris superliner ultra precision siyah eyeliner	COL name VAL loreal paris ruj color riche lipstick 00 orange after 	0
COL name VAL loraal paris les macarons likit nocolor cbb n light with neutral beige 820 neon fuchsia sedefli beyaz hologram paris	COL name VAL loreal paris kapataca true match concealer 3rc rose beige 	0
COL name VAL loreal paris true match bakim yapan fondoten 2r rose vanilla	COL name VAL loreal paris fondoten true match no2r2c vanilla rose	1
COL name VAL loreal paris mat ruj color riche matte addiction lipstick 640 erotique	COL name VAL loreal paris unbelieva brow uzun sa14re kalaca kaay jeli 217 brunette	0
COL name VAL loreal paris emotions of m rusted allak far paleti sky maskara seti	COL name VAL loreal paris unlimited siyah maskara 2li set	0
COL name VAL loreal paris loreal paris infaillible 24h tum yuze uygulanabilir kapatici 330 pecan	COL name VAL 24h yuze 330 pecan	1
COL name VAL loreal paris loreal paris infaillable automatic jel goz kalemi zumrut yesili	COL name VAL loreal paris infaillable automatic jel goz kalemi zumrut yesili	1
COL name VAL loraal paris true match pudra 3r3c antrisit giri beige opale	COL name VAL loreal paris parlataca ruj rouge signature lip topper 212 pure gold 	0
COL name VAL loraal paris infallible waterproof gel crayon eyeliner 16 morocco life	COL name VAL loreal paris tekli gaz fara color queen mono eyeshadow 26 stunner 	0
COL name VAL loreal paris 24h fresh wear fondaten natural rose kapataca makyaj organizer	COL name VAL loreal paris infaillible matte lip crayon kalem mat ruj 134 caramel blondie	0
COL name VAL loreal paris true match bakam yapan fondaten 2r rose vanilla	COL name VAL loreal paris le liner signature gaz kalemi 11ml taupe grey tweed	0
COL name VAL loreal paris micellar purenudeset temizleme suyu normalden ve kuruya satin cup ciltler iain 200 joker	COL name VAL loraal paris true match bakam yapan fondaten 4n beage	0
COL name VAL loreal paris ral infmacaronsnu fc 818 dose of ros	COL name VAL loraal paris infaillible dudak kalemi 213 stripped brown kahverengi	0
COL name VAL loraal paris les macarons likit gobi sweet cherry 818 dose of rose porcelain	COL name VAL loreal paris volume million lashes maskara cannes koleksiyonu azel tasaram 	0
COL name VAL loreal paris glow mon redrage likit aydanlataca loving explorer 02	COL name VAL loreal paris color richa ultra matte mat ruj no 6 hesitation	0
COL name VAL loreal paris tekli goz fari color queen mono eyeshadow 29 ruthless	COL name VAL bb krem orta ton perfection bb cream spf 50 ml	0
COL name VAL loreal paris infaillible sculpt palette kontur paleti 01 light medium	COL name VAL loreal paris kontur paleti infallible sculpt contouring palette 03 mediumdark	1
COL name VAL loreal paris tekli gaz fara color queen mono eyeshadow 27 transcendent 	COL name VAL loraal paris true match allak 75ml rosy cheeks	0
COL name VAL loreal paris gaz fara infaillible paint nude eyeshadow 205 champagne 	COL name VAL loreal paris kaay serumu brow asast plumo and set 101d dark brunette	0
COL name VAL loreal paris 24h fresh wear fondoten 125 natural rose and kapatici 327 cashmere makyaj organizer	COL name VAL loreal 24h and 327	1
COL name VAL loreal paris siyah maskara false lash butterfly effect intenza	COL name VAL loreal paris maskara false lash butterfly effect	1
COL name VAL loreal paris color queen tekli gaz fara 31 crowned	COL name VAL loraal paris rouge caresse 350 aphrodite scarlet ruj	0
COL name VAL loreal paris infaillible 24h fondoten 140 golden beige	COL name VAL loreal paris 140 golden	1
COL name VAL loraal paris brow yesil dore skinny definer kaay kalemi 109 rose ivory	COL name VAL loraal paris rouge caresse ruj 07 cheeky magenta	0
COL name VAL loreal paris mardinal loreal paris visible lift serum insade mat 120	COL name VAL loraal paris infaillible 24h matte cover ya14ksek kapataca fondaten 181 natural rose	0
COL name VAL loreal paris true match bakim yapan fondoten 2n vanilla	COL name VAL loreal paris match bakim yapan fondoten rose beige	0
COL name VAL loreal paris true match bakim yapan fondoten 4n beige	COL name VAL loreal paris true match bakim yapan fondoten 4n beige	1
COL name VAL loreal mega collagene 24h maskara	COL name VAL loreal paris loreal paris mega volume collagene 24h siyah maskara	1
COL name VAL loraal paris true match bakam yapan fondaten 2d sandra nocolor ffaf	COL name VAL loreal paris loraal paris lash paradise intense black ekstra siyah maskara 1 paket 1 x 23 g	0
COL name VAL loreal paris color riche crayon liner 256 blush fever x2	COL name VAL loraal paris brilliant signature plump in gloss ruj 113 i insert	0
COL name VAL loraal paris paradise suya dayanakla siyah maskara	COL name VAL loraal paris color riche matte addiction ruj 25 obsidian mor	0
COL name VAL loreal paris true match bakam yapan fondaten 1d golden ivory	COL name VAL loreal paris 6d saat kalaca kalem no 909 stay blue	0
COL name VAL loraal paris in the buff liner signature gaz kalemi 05 black night denim	COL name VAL loraal paris volumissime royale x10 siyah maskara	0
COL name VAL loreal paris kahverengi kas kalemi brow artist designer eyebrow pencil 303 deep brown	COL name VAL loreal paris color riche le sourcil kas kalemi 303 deep brown	1
COL name VAL loreal paris ruj infallible mega gloss 404 raspoutine me 	COL name VAL loreal paris ruj lip paint metallic 50ml lolita 	0
COL name VAL loreal paris likit metalik ruj rouge signature metallic 206 i scintillate	COL name VAL loreal paris rouge signature metallic likit ruj 206 i scintillate	1
COL name VAL loreal paris kadan coolsand allak wake up and glow dark romance 03 koyugri dollar deep fuschia 	COL name VAL loreal paris true match bakam yapan fondaten 1d golden ivory	0
COL name VAL loreal paris sweetcoral color riche shine addiction lipstick 643 hot irl 	COL name VAL loraal paris la vie en glow aydanlataca paleti cool glow soayuk tonlar	0
COL name VAL loreal paris false lash butterfly effect mascara maskara	COL name VAL loreal paris siyah maskara false lash butterfly effect maskara	1
COL name VAL loreal paris color riche saten bitisli ruj 112 paris paris pembe	COL name VAL loreal paris color riche saten bitisliruj 112 paris paris pembe	1
COL name VAL loreal paris ruj color riche collection privee doutzens nude	COL name VAL loreal paris ruj color riche privee nudes doutzens nude	1
COL name VAL loreal paris ruj color riche privee nudes freida cp6	COL name VAL loreal paris ruj color riche collection privee freidas nude	1
COL name VAL loreal paris infaillible shaping stick aydinlatici 501 oh my jewels	COL name VAL loreal paris stick aydinlatici infaillible shaping stick 501 oh my jewels	1
COL name VAL loreal paris ruj color riche lipstick 330 cocorico	COL name VAL loreal paris color riche ruj matte 330 cocorico	1
COL name VAL loreal paris siyah maskara volume million lashes feline mascara black 	COL name VAL loreal paris loraal paris true match bakam yapan fondaten 006 beage	0
COL name VAL loraal paris cam yesili signature sari beyaz gri likit deep with warm olive 203 i magnetize	COL name VAL loreal paris loreal true match nude serum fondaten light 360 fondaten faraasa	0
COL name VAL loreal paris kadan no color ruj	COL name VAL loraal paris infaillible shaping stick fondaten 313 caramel	0
COL name VAL loreal paris true match bakim yapan fondoten 5r rose sand	COL name VAL paris bakim fondoten 5r rose	1
COL name VAL loreal paris loraal paris infaillible 24h ta14m ya14ze uygulanabilir kapataca 330 pecan	COL name VAL loreal paris fondaten infallible 868 sable 	0
COL name VAL loreal paris nocolor acd shine balmy gloss 915	COL name VAL loreal paris loraal paris bronze to paradise mat bronzlaaytaraca pudra 02 baby one more tan	0
COL name VAL loreal paris likit nocolor fdc fenty beau killawatt face day 102	COL name VAL loraal paris true match pudra 4n beige	0
COL name VAL loreal paris goz fari infallible eyeshadow paint 302 immortal black	COL name VAL loreal paris infaillible eye paint goz fari 302 immortal black	1
COL name VAL loreal paris color riche les nus ruj 182 nu extreme	COL name VAL loreal paris riche les ruj extreme	1
COL name VAL loreal paris likit orijinal wine on time les chocolats ultra acik krem liquid lipstick 858 oh my choc 	COL name VAL loreal paris infaillable automatic jel gaz kalemi yoayun siyah	0
COL name VAL loreal paris infaillible ta14m ya14ze uygulanabilir kapataca 327 tirnak yapistiricisi	COL name VAL loraal paris infaillible 24h fondaten 145 rose beige	0
COL name VAL loreal paris ruj riche free the 05 diktat	COL name VAL loreal paris ruj color riche free the nudes 05 no diktat	1
COL name VAL loraal paris true match bakam yapan fondaten 1n ivory	COL name VAL loreal paris rouge signature empowereds likit mat ruj 338 discovered 	0
COL name VAL loreal paris cest magic bb krem 05 medium dark 	COL name VAL loreal paris magic bb 05 	1
COL name VAL loreal paris infaillible magic setting makyaj sabitleyici sprey 	COL name VAL loreal paris color riche saten bitiayli ruj 180 paris paris pembe	0
COL name VAL loreal paris true match yapan fondoten 55d golden	COL name VAL loreal paris true match bakim yapan fondoten 55d golden sun	1
COL name VAL loreal paris true match bakim yapan fondoten creamy beige kategori fondoten	COL name VAL paris bakim fondoten beige kategori fondoten	1
COL name VAL loreal paris true match bakim yapan fondoten 15 linen	COL name VAL paris match bakim yapan linen	1
COL name VAL loraal paris color riche x balmain collection safari woman mat ruj 648 glamazone	COL name VAL loraal paris infaillible dudak kalemi 17 stripped brown kahverengi	0
COL name VAL loreal paris color riche shine naked tans ruj 658 topless nude	COL name VAL loreal paris true match bakam yapan fondaten 01 linen	0
COL name VAL loreal paris color riche ruj matte addiction 241 coral style	COL name VAL loreal paris color riche matte addiction ruj 241 pink a porter	1
COL name VAL loreal paris les macarons likit mat ruj 818 dose of rose	COL name VAL loreal paris likit mat ruj les macarons ultra matte liquid lipstick 818 dose of ros	1
COL name VAL loreal paris infaillible ta14m ya14ze uygulanabilir kapataca 327 cashmere	COL name VAL loreal paris lacivert gaz kalemi contour khol kajal 6n blue denim 	0
COL name VAL loreal paris infaillible 24h fleurfatale cover ya14ksek kapataca fondaten	COL name VAL loraal paris infaillible matte lip crayon kalem mat ruj 110 caramel rebel 1 paket 1 x 1	0