COL name VAL loreal paris rouge signature empowereds likit mat ruj empowered	COL name VAL loreal paris rouge signature empowereds likit mat ruj empowered	1
COL name VAL loreal paris super lider peachella lacquer waterproof eye orangebrick	COL name VAL loreal paris telescopic gold siyah maskara and infaillible h fresh wear pudra fondoten vanilla	0
COL name VAL loreal paris skin paradise su bazli renkli nemlendirici light	COL name VAL loreal paris skin paradise su bazli renkli nemlendirici light	1
COL name VAL loreal infallible fresh wear h fondoten rose ivory	COL name VAL loreal paris infaillible h fresh wear c vitaminli fondoten rose ivory	1
COL name VAL loreal paris brod artist pert no cool brunette	COL name VAL loreal paris brod artist pert no cool brunette	1
COL name VAL loreal paris telescopic carbon black maskara siyah and infaillible h fresh wear pudra fondoten vanilla	COL name VAL loreal paris suya dayanakla siyah eye lider super black lacquer waterproof ml	0
COL name VAL lorsal paris color riche plump and sine metallik white true gold nocolor cadde	COL name VAL loreal paris dudak kalemi infaillible lip bencil higlight on point	0
COL name VAL loreal paris tekli gaz fara color nocolor ceed mono eyeshadow popular nude	COL name VAL lorsal paris rouge signature empowereds likit mat ruj discovere	0
COL name VAL loreal paris infaillible magic settings last night damla uc mavi mm sprey	COL name VAL lorsal paris true match bakam yapan fondoten r rose amber	0
COL name VAL loreal paris dudak kalemi infaillible lip bencil free spirit with the peach sohbet	COL name VAL loreal paris infaillible h fresh wear c vitaminli fondoten rose ivory	0
COL name VAL loreal paris dudak kalemi infaillible lip bencil apocalypse famous red	COL name VAL loreal paris brod artist plumpandset renkli kaya sabitleyici maskara	0
COL name VAL loreal paris color pinkprincess tekli gaz fara acikkahve	COL name VAL lorsal paris miceller kusursuz makyaj temizleme suyu normal ml	0
COL name VAL loreal paris lorsal true match bakam yapan fondoten d golden amber	COL name VAL loreal paris ruj color riche sine addiction lipstick only in	0
COL name VAL loreal paris infaillible shaping stick fondoten vanilla	COL name VAL loreal paris infaillible shaping stick fondoten vanilla	1
COL name VAL lorsal paris infaillible gel arayon gaz kalemi white is beyaz	COL name VAL loreal paris tekli gaz fara color queen mono eyeshadow rc	0
COL name VAL loreal paris ruj color riche rouge careyse lipstick impulsive fuschia	COL name VAL loreal paris color riche lipstick	0
COL name VAL lorsal paris true match allak summerscent in celebutante	COL name VAL loreal paris likit mat ruj les macarons ultra liquid lipstick blackcurrant crush	0
COL name VAL lorsal paris telescopic maskara crimsoncream li	COL name VAL loreal paris true match bakam yapan fondoten n belge	0
COL name VAL lorsal paris rouge careyse ruj lovely rose	COL name VAL loreal paris rouge signature likit mat ruj i represent	0
COL name VAL loreal paris blow cherie aydinlik veren renkli nemlendirici porcelain low	COL name VAL loreal paris likit aydinlatici blow cherie high light	1
COL name VAL lorsal paris true match bakam yapan fondoten d golden sun	COL name VAL loreal paris true match foundation spf amber ml	0
COL name VAL loreal paris infaillible nudist eye paint cocky bosque	COL name VAL loreal paris goz fari infaillible paint nude eyeshadow champagne	1
COL name VAL loreal paris color riche plump sine ruj mulberry	COL name VAL loreal paris color riche plump sine ruj mulberry	1
COL name VAL loreal paris true match gaz kremi aseren kapatacak si arada r peach	COL name VAL loreal paris stick allak infaillible shaping nude in rose	0
COL name VAL loreal paris miceller makyaj temizleyici paradise intense maskara seti	COL name VAL lorsal paris brillant signature plump in glass ruj i leighten	0
COL name VAL lorsal paris blow mon amour melon dollar baby likit aydanlataca no ml	COL name VAL lorsal paris brod artist high contour cool brunette koyu kumral	0
COL name VAL lorsal paris true match high light aydanlataca pudra dw golden low	COL name VAL loreal paris allak true match le blush no n nektarine	0
COL name VAL lorsal paris rouge signature parisien sunset likit mat ruj i radiate	COL name VAL lorsal paris les macarons likit mat ruj mademoiselle mango	0
COL name VAL lorsal paris infaillible h fondoten golden belge	COL name VAL loreal paris jel siyah eye lider gel intenza h si pure black	0
COL name VAL lorsal paris cast magic bb krem medium light	COL name VAL loreal paris color queen tekli gaz fara dw stunner	0
COL name VAL loreal paris rouge signature metallik likit ruj i voodoo	COL name VAL loreal paris likit metalik ruj rouge signature metallik i voodoo	1
COL name VAL lorsal paris infaillible dudak kalemi wuthering purple mardam	COL name VAL lorsal paris infaillible lip paint likit ruj mat tanzerine vertigo	0
COL name VAL loreal paris air volume easy waterproof suya dayanakla maskara siyah	COL name VAL loreal paris tekli gaz fara color queen mono eyeshadow n dont stop me	0
COL name VAL loreal paris waterproof arayon eye lider golden	COL name VAL loreal paris waterproof arayon eye lider golden	1
COL name VAL loreal paris rouge signature parisien sunset likit mat ruj i decide	COL name VAL loreal paris rouge signature parisien sunset likit mat ruj i decide	1
COL name VAL loreal paris ruj infallible mega glass hos the boss	COL name VAL loreal paris ruj infallible mega glass hos the boss	1
COL name VAL loreal paris infaillible eye lider stay blue	COL name VAL loreal paris infaillible eye lider stay blue	1
COL name VAL loreal paris true match nude serum fondoten light	COL name VAL loreal paris pudra true match power rose belge	0
COL name VAL loreal paris c st magic bb krem medium dark	COL name VAL loreal paris c st magic bb krem medium dark	1
COL name VAL loreal paris karaaytarma farajsa	COL name VAL lorsal paris true match bakam yapan fondoten porcelaan	0
COL name VAL loreal paris aydanlataca palet en blow warm farka seti	COL name VAL lorsal paris rouge signature lip hopper dudak parlatacak ruj white gold	0
COL name VAL lorsal paris true match bakam yapan fondoten d miss blossom socialite	COL name VAL loreal paris mega volume collagene h siyah maskara	0
COL name VAL loreal paris telescopic gold siyah maskara infaillible h fresh wear pudra fondoten vanilla	COL name VAL loreal paris telescopic gold siyah maskara infaillible h fresh wear pudra fondoten vanilla	1
COL name VAL lorsal paris infaillible h gaz kalemi nude obsession	COL name VAL lorsal paris les chocolate likit mat ruj yum	0
COL name VAL lorsal paris bambi eye ceylan gaz etkili maskara siyah	COL name VAL lorsal paris rumi magique kapatacak rck medium	0
COL name VAL lorsal paris infaillible h fondoten koyu ton	COL name VAL loreal paris rouge signature mat likit ruj rule	0
COL name VAL loreal paris siyah maskara falso lash wings midnight black	COL name VAL loreal paris wings midnight siyah maskara	1
COL name VAL loreal paris kahverengi eye lider infallible style h nude obsession	COL name VAL loreal paris kahverengi eye lider infallible style h nude obsession	1
COL name VAL loreal paris telescopic carbon siyah maskara	COL name VAL loreal paris telescopic carbon siyah maskara	1
COL name VAL loreal paris parlatacak ruj rouge signature lip hopper rose gold	COL name VAL lorsal paris infaillible sculpt palette kontar paleti medium dark	0
COL name VAL loreal paris bubble peach smokey diamond	COL name VAL loreal paris siyah paradise maskara	0
COL name VAL loreal paris million lashes maskara maude moment koyugri koyuyesil medium golden warm	COL name VAL lorsal paris les macarons likit mat ruj blackcurrant crush	0
COL name VAL loreal paris x isabel marat lipstick limited edition	COL name VAL loreal paris x isabel marat lipstick limited edition	1
COL name VAL lorsal paris true match bakam yapan fondoten d graham crocker pleaseme	COL name VAL lorsal paris color riche x balmain collection rock woman mat ruj legend	0
COL name VAL lorsal paris brod natural brown pert danger stay away afterhours violet space	COL name VAL lorsal paris color riche free the nudes ruj no lies	0
COL name VAL lorsal paris anfaillible eye lider stay koyu bitter kahve	COL name VAL loreal paris true match bakam yapan fondoten lanen	0
COL name VAL loreal paris waterproof arayon eye lider private	COL name VAL loreal paris true match bakam yapan fondoten n belge	0
COL name VAL loreal paris color riche ruj mat cocorico	COL name VAL loreal paris ruj color riche lipstick cocorico	1
COL name VAL loreal paris cremedelacreme eye lider infaillible gel arayon stay the night	COL name VAL loreal paris saat kalaca kalem no	0
COL name VAL loreal paris pure nonchalance lider signature gaz kalemi y nrosepink cherry chari	COL name VAL lorsal paris superliler perfect slim siyah eye lider	0
COL name VAL lorsal paris infaillible shaping stick allak sexy flash	COL name VAL loreal paris siyah smokinsime superliler black	0
COL name VAL loreal paris dudak kalemi infaillible lip bencil white is	COL name VAL loreal paris infaillible gel arayon goz kalemi white is beyaz	1
COL name VAL loreal paris ka kalemi brod artist pert warm bruce	COL name VAL loreal paris ka kalemi brod artist pert warm bruce	1
COL name VAL lorsal paris infaillible h duy head fondoten vera orb	COL name VAL loreal paris infaillible h mat cover yaksek kapatacak fondoten no amber	0
COL name VAL loreal paris infaillible eye lider stay blue	COL name VAL loreal paris saat kalici kalem no stay blue	1
COL name VAL loreal paris likit ruj color riche l extraordinaire lipstick ruby opera	COL name VAL loreal paris extraordinaire ruby opera	1
COL name VAL loreal paris jel kas pomadi brod artist pomada no : warm blonde	COL name VAL loreal paris jel kas pomadi brod artist pomada no : warm blonde	1
COL name VAL lorsal paris brod hot choca pert ilac sparkla srtry	COL name VAL lorsal paris infaillible h fondoten golden sand	0
COL name VAL loreal paris likit ruj infallible lip paint lacquer fuchsla wars	COL name VAL loreal paris kaya kiti ayak brod artist genius kit light to medium orta ton	0
COL name VAL loreal paris likit mat ruj infaillible lip paint hollywood belge	COL name VAL loreal paris likit mat ruj infaillible lip paint hollywood belge	1
COL name VAL loreal paris ultra mat liquid lipstick candy man les chocolate ml	COL name VAL loreal paris ultra mat liquid lipstick candy man les chocolate ml	1
COL name VAL loreal paris tekli goz fari color queen mono eyeshadow determination	COL name VAL loreal paris tekli goz fari color queen mono eyeshadow determination	1
COL name VAL loreal paris likit kiss of klimt burnu raisin mat les chocolate ultra yoga therapy liquid lipstick simli yesil man	COL name VAL loreal paris isabel marat color riche ruj belleville rodeo	0
COL name VAL lorsal paris infaillible h fondoten amber	COL name VAL loreal paris pudra true match power rose vanilla	0
COL name VAL loreal paris morumsu bordo color riche free the f n black navy metalikkahverengi hesitation	COL name VAL loreal paris siyah bambi eye oversized ceylan gaz etkili maskara	0
COL name VAL loreal paris true match bakam yapan fondoten r rose vanilla	COL name VAL lorsal paris color riche saten bitiayli ruj pink pigalle pembe	0
COL name VAL loreal paris true match fondoten n vanilla	COL name VAL loreal paris lacivert gaz kalemi contour kol kanal blue denim	0
COL name VAL lorsal paris brod silk peach genius kit belge nature to can breeze vf ayaktan ortaya	COL name VAL loreal paris lorsal true match bakam yapan fondoten n belge	0
COL name VAL loreal paris true match bakam yapan fondoten d sablemoyen belge	COL name VAL loreal paris dore tonlarinda aydanlataca true match high light d w golden blow	0
COL name VAL loreal paris metallik wang a brown color riche exclusive pink eva pure violet	COL name VAL loreal paris true match bakam yapan fondoten d golden ivory	0
COL name VAL loreal paris tekli gaz fara color queen mono eyeshadow influence	COL name VAL lorsal paris infaillible shaping stick fondoten natural rose	0
COL name VAL lorsal paris color riche dry merlot volume siyahvebeyaz hangouts capi ail acik leylak independent	COL name VAL loreal paris true match bakam yapan fondoten n ivory	0
COL name VAL loreal paris likit dc natural rosewood yesilmavituruncu les macarons ultra fc grege liquid lipstick mademoiselle mango	COL name VAL loreal paris true match bakam yapan fondoten r rose ivory	0
COL name VAL loreal botanicals infallible longwear shaping stick	COL name VAL lorsal paris color riche mat addiction ruj scarlet silhouette karmasa	0
COL name VAL lorsal paris eye go nocolor abb paleti	COL name VAL lorsal paris true match bakam yapan fondoten r rose belge	0
COL name VAL loreal paris brod artist skinny define kas kalemi dark blonde	COL name VAL loreal paris brod artist skinny define kas kalemi dark blonde	1
COL name VAL loreal paris lorsal infaillible h tam yaze uygulanabilir kapatacak vecan	COL name VAL loreal paris fondoten infallible sale	0
COL name VAL lorsal paris infaillible h mat cover yaksek kapatacak fondoten rose belge	COL name VAL loreal paris true match bakam yapan fondoten rose belge	0
COL name VAL lorsal paris crosswires signature parisien truebeige likit nudes renkli cold bre i decide	COL name VAL lorsal paris infaillible h fondoten radiant honey	0
COL name VAL loreal paris true match bakam yapan fondoten n ivory	COL name VAL loreal paris kontar paleti infallible sculpt contouring palette mediumlight	0
COL name VAL lorsal paris infallible stay cl dudak kalemi	COL name VAL loreal paris lorsal color riche ruj violet saturne pembe	0
COL name VAL loreal paris true match bakam yapan fondoten d golden ivory	COL name VAL loreal paris color riche plump and sine ruj nektarine	0
COL name VAL loreal paris nocolor fcbfea defe bazla punk zenginkahve red correct kemik rengi	COL name VAL loreal paris infaillible h mat cover yaksek kapatacak fondoten golden amber	0
COL name VAL loreal paris lorsal color riche plump and sine ruj	COL name VAL lorsal paris true match bakam yapan fondoten golden sand	0
COL name VAL loreal paris gaz fara infaillible paint nude eyeshadow champagne	COL name VAL loreal paris kaya serumu brod asist pluto and set d dark brunette	0
COL name VAL loreal para ruj lap paint metalla lolita	COL name VAL loreal paris le diner signature kahverengi gaz kalemi	0
COL name VAL loreal paris lorsal true match bakam yapan fondoten n belge	COL name VAL loreal paris mor eye lider infallible gel arayon purple	0
COL name VAL loreal paris infaillible h mat cover yaksek kapatacak fondoten natural rose	COL name VAL loreal paris true match bakam yapan fondoten golden sand	0
COL name VAL loreal paris pearli violet pudra orangebeige tadaussac power	COL name VAL loreal paris rouge signature likit mat ruj	0
COL name VAL loreal paris goz fari paleti la petite palette nudist	COL name VAL loreal paris la petite far paleti nudist	1
COL name VAL loreal paris le diner signature mor goz kalemi	COL name VAL loreal paris le diner signature mor goz kalemi	1
COL name VAL loreal paris mega volume miss manga maskara	COL name VAL loreal paris mega volume miss manga maskara	1
COL name VAL lorsal paris true match bakam yapan fondoten r nocolor adf porcelaan	COL name VAL loreal paris likit mat ruj rouge signature enjoy	0
COL name VAL loreal paris stick aydinlatici infaillible shaping gold is cold	COL name VAL loreal paris stick aydinlatici infaillible shaping gold is cold	1
COL name VAL loreal paris true match allik luminous rose	COL name VAL loreal paris true match allik luminous rose	1
COL name VAL loreal paris likit haute burgundy dalgali mavi les macarons ultra higlight on point liquid lipstick blackcurrant m rosewood sine	COL name VAL lorsal paris true match prestige pudra d golden belge	0
COL name VAL loreal paris bronz pudra lam dua power no :	COL name VAL loreal paris bronz pudra lam dua power no :	1
COL name VAL lorsal paris true match bakam yapan fondoten r rose ivory	COL name VAL loreal paris true match bakam yapan fondoten golden ivory	0
COL name VAL lorsal paris infaillible h vegas volt cover yaksek kapatacak fondoten rose biscuits	COL name VAL lorsal paris bambi eye ceylan gaz etkili maskara siyah	0
COL name VAL loreal paris volume millions de cile siyah maskara	COL name VAL loreal paris likit kompakt fondoten nude magique liquid cushion foundation golden amber	0
COL name VAL loreal paris miceller	COL name VAL loreal paris miceller	1
COL name VAL loreal paris ruj color riche lipstick androgyne	COL name VAL loreal paris color riche ruj mat androgyne	1
COL name VAL loreal paris iayalta saylayan fondoten l mi macique foundation dw rhythm red vibrand rosewood	COL name VAL infaillible h fresh wear pudra fondoten golden belge	0
COL name VAL loreal paris lorsal true match bakam yapan fondoten r acik kahve vize geranim red	COL name VAL loreal paris ruj no	0
COL name VAL loreal paris lorsal true match ivory fondoten serum very craving	COL name VAL loreal paris lorsal true match bakam yapan fondoten inen	0
COL name VAL loreal paris miceller makyaj temizleyici paradise intense maskara seti	COL name VAL lorsal paris infaillible h mat cover yaksek kapatacak fondoten sablesand	0
COL name VAL loreal paris color queen tekli goz fari high potential	COL name VAL loreal paris color queen tekli goz fari high potential	1
COL name VAL loreal paris blow mon amour likit aydinlatici living peach	COL name VAL loreal paris blow mon amour likit aydinlatici living peach	1
COL name VAL lorsal paris infaillible h mat cover yaksek kapatacak fondoten true belge	COL name VAL lorsal paris true match bakam yapan fondoten ivory	0
COL name VAL loreal paris siyah eye lider superliler perfect slim	COL name VAL loreal paris siyah eye lider superliler perfect slim	1
COL name VAL loreal paris infaillible more tan concealer wisteria purple ivory ml	COL name VAL loreal paris telescopic maskara siyah	0
COL name VAL lorsal paris infaillible h gaz kalemi light medium with warm yellow undertones metalik	COL name VAL lorsal paris true match bakam yapan fondoten d golden ivory	0
COL name VAL loreal paris infaillable lipgloss sayonara sunset	COL name VAL loreal paris infaillible h concealer pomada kapatacak medium	0
COL name VAL lorsal paris infaillible eye paint gaz fara soft black for dark brown to hair redviolet	COL name VAL lorsal paris brod artist high contour brunette a kumral	0
COL name VAL loreal paris likit mat ruj les chocolate ultra liquid lipstick sweet toth	COL name VAL loreal paris les chocolate likit mat ruj sweet toth	1
COL name VAL loreal paris fondoten no visible lift	COL name VAL loreal paris visible lift serum inside mat	1
COL name VAL loreal paris color queen tekli goz fari commander	COL name VAL loreal paris color queen tekli goz fari commander	1
COL name VAL lorsal paris infaillible h deep bony fondoten nocolor baba chicstelietto	COL name VAL loreal paris dore tonlarinda aydanlataca true match high light d w golden blow	0
COL name VAL loreal paris kaya kalemi brod dark purple high contour marvelous maude spice nude	COL name VAL loreal paris blow mon amour droplet high light bronz in love likit aydanlataca	0
COL name VAL loreal paris mavi gaz kalemi contour kol portofino blue	COL name VAL lorsal paris infaillible h ruj permanant blush nude	0
COL name VAL lorsal paris true match bakam yapan fondoten n kanalla	COL name VAL loreal paris color riche x balmain ruj d legend kahverengi	0
COL name VAL lorsal paris color riche x balmain collection rose stiletto woman indian curry renksiz seffaf glamazone	COL name VAL loreal paris rouge signature empowereds likit mat ruj discovere	0
COL name VAL loreal paris uzun sare kalaca fondoten infaillible h you reno good wear siyah moon pust	COL name VAL lorsal paris infaillible h ultra mat prestige pudra belge	0
COL name VAL loreal paris infaillible resurfacing gozenek gizleyici ve parazsazleaytirici raspberry baza	COL name VAL lorsal paris brod artist high contour bony esmer	0
COL name VAL loreal paris les macarons ultra rouge cherie likit ligthbrown framboise	COL name VAL lorsal paris rouge signature likit mat ruj i am worth it	0
COL name VAL loreal paris nude ivory romantik salmon color riche m elegance addiction bordeaux red sautoir	COL name VAL loreal paris true match bakam yapan fondoten r rose vanilla	0
COL name VAL loreal paris true mach yaaysan fondoten n papatya	COL name VAL loreal paris waterproof arayon eye lider golden	0
COL name VAL lorsal paris superliler smokinsime eye lider nocolor fdbbd	COL name VAL loreal paris aydanlar veren renkli nemlendirici blow cherie light	0
COL name VAL loreal paris infaillible h fondoten natural rose	COL name VAL loreal paris fondoten infallible fondh natural rose	1
COL name VAL loreal paris vermillon color riche lipstick lightmediumwithneutral after	COL name VAL loreal paris unbelieva brod uzun sare kalaca kaya jeli brunette	0
COL name VAL loreal paris color riche satin ruj	COL name VAL lorsal paris brod artist pert no warm brunette	0
COL name VAL loreal paris lorsal true match bakam yapan fondoten r rose ivory ml	COL name VAL loreal paris kapatacak infaillible h concealer pomada peach	0
COL name VAL loreal paris infaillible h mat fondoten mal honey	COL name VAL lorsal paris color riche dudak kalemi bois de rose nude	0
COL name VAL loreal paris siyah bambi eye oversized ceylan goz etkili maskara	COL name VAL loreal paris siyah bambi eye oversized ceylan goz etkili maskara	1
COL name VAL lorsal paris color riche ruj pink anac	COL name VAL lorsal paris infaillible dudak kalemi red fiction karmasa	0
COL name VAL loreal paris rouge signature parisien sunset likit mat ruj lead	COL name VAL loreal paris rouge signature parisien sunset likit mat ruj lead	1
COL name VAL loreal paris infallible mattifying base belge amber	COL name VAL lorsal paris true match prestige pudra n vanilla	0
COL name VAL loreal paris infaillible mat lip arayon kalem ruj brul e everyday	COL name VAL loreal paris mat lip arayon no brulse everday kalem ruj	1
COL name VAL loreal paris infaillible step saat kalici likit ruj bal metroproof rose	COL name VAL loreal paris infaillable lipstick step metro pro	1
COL name VAL loreal paris le diner signature mavi goz kalemi	COL name VAL loreal paris le diner signature mavi goz kalemi	1
COL name VAL loreal paris true match bakam yapan fondoten n sand	COL name VAL loreal paris volume million lashes natale maskara siyah ml	0
COL name VAL lorsal paris infaillible h fondoten frosted maude mediumbeige	COL name VAL loreal paris ruj lip paint metallik lolita	0
COL name VAL loreal paris likit mat ruj les macarons ultra liquid lipstick blackcurrant crush	COL name VAL loreal paris rouge signature mat likit ruj represent	0
COL name VAL lorsal paris superliler smokinsime eye lider koyu	COL name VAL loreal paris true match bakam yapan fondoten lanen	0
COL name VAL loreal paris volumissime x tumnumaralar assertive maskara nberrystain	COL name VAL loreal paris true match nude serum fondoten very light farajsa seti	0
COL name VAL loreal paris mat ruj color riche addiction lipstick pink ready to we	COL name VAL loreal paris mat ruj color riche addiction lipstick pink ready to we	1
COL name VAL lorsal paris infaillible h ruj permanant blush nude	COL name VAL loreal paris dudak kalemi infaillible lip bencil stay ultraviolet	0
COL name VAL loreal paris dudak kalemi infaillible lip bencil magicmaker fiction	COL name VAL lorsal paris les chocolate likit mat ruj box of chocolatem	0
COL name VAL loreal paris brod artist shapen kas kalemi blonde	COL name VAL loreal paris brod artist shapen kas kalemi blonde	1
COL name VAL loreal paris rouge signature metallik likit ruj i scintillate	COL name VAL loreal paris likit metalik ruj rouge signature metallik i scintillate	1
COL name VAL loreal paris true match bakam yapan fondoten r rose ivory	COL name VAL lorsal paris infaillible shaping stick fondoten capuccino	0
COL name VAL lorsal paris extraordinaire ruby opera	COL name VAL loreal paris infaillible h mat cover yaksek kapatacak fondoten radiant vanilla	0
COL name VAL loreal paris infaillible h mat cover yuksek kapatici fondoten rose porcelain	COL name VAL loreal paris infaillible h mat cover yuksek kapatici fondoten rose porcelain	1
COL name VAL loreal paris les macarons likit mat ruj strawberry savage	COL name VAL loreal paris les macarons likit mat ruj strawberry savage	1
COL name VAL loreal paris true match bakam yapan fondoten n lavender forfairtolightskintones	COL name VAL lorsal paris true match bakam yapan fondoten d golden sun	0
COL name VAL lorsal paris les macarons likit mat ruj guava rush	COL name VAL loreal paris color riche intense volume mat ruj nude independent	0
COL name VAL loreal paris lorsal infaillible tam yaze uygulanabilir kapatacak honey	COL name VAL loreal paris super lider gelmatic d deep violet mor gaz kalemi	0
COL name VAL loreal paris ka kalemi brod artist pert warm bruce	COL name VAL loreal paris brod artist pert no warm brunette	1
COL name VAL loreal paris true match bakam yapan fondoten n belge	COL name VAL lorsal paris infaillible h mat cover yaksek kapatacak fondoten golden sun	0
COL name VAL loreal paris ruj color riche rouge careyse lipstick impulsive fuschia	COL name VAL loreal paris careyse lipstick ruj	1
COL name VAL loreal paris le linersignature gold sari goz kalemi	COL name VAL loreal paris le diner signature goz kalemi gold velvet	1
COL name VAL lorsal paris cast magic bb krem light	COL name VAL loreal paris bronzlaaytaraca pudra bronz please taormina intenso	0
COL name VAL loreal paris color riche x balmain collection safari woman mat ruj glamazone	COL name VAL loreal paris color riche x balmain collection safari woman mat ruj	1
COL name VAL loreal paris lorsal infaillible h nudekahve wear pink blow vitaminli fondoten true degrade gul kurucu	COL name VAL lorsal paris infaillible tam yaze uygulanabilir kapatacak vanilla	0
COL name VAL loreal paris true match bakam yapan fondoten n belge	COL name VAL loreal paris likit mat ruj les macarons ultra liquid lipstick dose of ros	0
COL name VAL lorsal paris superliler ultra precisin siyah eye lider	COL name VAL loreal paris ruj color riche lipstick orange after	0
COL name VAL loreal paris likit mat ruj infallible lip paint tanzerine vertigo	COL name VAL loreal paris parlatacak ruj rouge signature lip hopper white gold	0
COL name VAL loreal paris rimel volume million lashes cannes ozel tasarim siyah	COL name VAL loreal paris volume million lashes maskara cannes koleksiyonu ozel tasarim	1
COL name VAL loreal paris true match pudra d / w golden belge	COL name VAL loreal paris true match pudra d / w golden belge	1
COL name VAL loreal paris gram sine calmy glass	COL name VAL loreal paris lorsal demo expertinse kusursuz mak tem suyu d ml normal	0
COL name VAL lorsal paris blow mon amour melon dollar baby likit aydanlataca no ml	COL name VAL loreal paris allak and bronzlaaytaraca pudra blush cherie on the cake bronzer dark chocolate	0
COL name VAL loreal paris brillant signature plump in glass ruj i inflate	COL name VAL loreal paris brillant signature plump in glass ruj i inflate	1
COL name VAL loreal paris ruj labial color riche careyse lipstick lovely rose	COL name VAL loreal paris allak ve bronzlaaytaraca pudra blush cherie on the cake bronzer dark chocolate	0
COL name VAL loreal paris ruj color riche free the nudes no clicke	COL name VAL lorsal paris nude magique cushion fondoten golden amber	0
COL name VAL loreal paris les chocolate ultra mat likit ruj candy man	COL name VAL loreal paris true match bakam yapan fondoten ivory	0
COL name VAL lorsal paris les chocolate likit irrepressible qd bubblegum volupto dreamcatcher	COL name VAL lorsal paris true match bakam yapan fondoten d golden sand	0
COL name VAL loreal paris infaillible mat lip arayon kalem ruj flirty coffee	COL name VAL loreal paris infaillible mat lip arayon kalem ruj flirty coffee	1
COL name VAL lorsal paris rouge signature likit mat ruj i represent	COL name VAL loreal paris color riche saten bitiayli ruj pembe	0
COL name VAL lorsal paris infaillible h pudra pembe tonlari white frost downtown	COL name VAL lorsal paris paradise orman meyvesi kokulu mor maskara	0
COL name VAL loreal paris tekli gaz fara color queen mono eyeshadow charger	COL name VAL lorsal paris les chocolate likit mat ruj candy man	0
COL name VAL lorsal paris true match bakam yapan fondoten n ivory	COL name VAL loreal paris rouge signature empowereds likit mat ruj discovere	0
COL name VAL loreal paris infaillible paint gel arayon eye lider hava vonum violet	COL name VAL loreal paris infaillible paint gel arayon eye lider hava vonum violet	1
COL name VAL loreal paris likit coral game english rose jl marmeladi signature i dont	COL name VAL lorsal paris lash architects d siyah maskara	0
COL name VAL lorsal paris infaillible lip paint likit ruj mat king pink	COL name VAL lorsal paris brod artist high contour cool brunette koyu kumral	0
COL name VAL loreal paris true match bakam yapan fondoten r rose belge	COL name VAL loreal paris ruj lip paint metallik n lolita	0
COL name VAL loreal paris buttercup color riche sine addiction lipstick touch of rose	COL name VAL loreal expert lorsal paris mega volume collagene h siyah maskara	0
COL name VAL lorsal paris infaillible tam yaze uygulanabilir kapatacak honey	COL name VAL loreal paris rouge signature mat likit ruj achaeve	0
COL name VAL loreal paris air volume mega maskara	COL name VAL loreal paris ruj color riche sine addiction lipstick yol	0
COL name VAL loreal paris true match bakam yapan fondoten lanen	COL name VAL loreal paris infaillible h mat cover yaksek kapatacak fondoten sablesand	0
COL name VAL lorsal paris infaillible shaping stick fondoten yesil cicekli g chocolate mouse	COL name VAL loreal paris kahverengi kaya kalemi brod artist designe eyebrow bencil golden brown	0
COL name VAL loreal paris siyah maskara miss manga	COL name VAL loreal paris siyah maskara miss manga	1
COL name VAL loreal paris smoke x isabel marat gaz fara paleti gr	COL name VAL loreal paris les chocolate likit mat ruj volupto chico	0
COL name VAL loreal paris lorsal true match bakam yapan fondoten n belge	COL name VAL loreal paris paradise su bazla renkli nemlendirici fair	0
COL name VAL loreal paris color queen tekli goz fari force	COL name VAL loreal paris color queen tekli goz fari force	1
COL name VAL loreal paris mat ruj color riche addiction lipstick mahogandy study	COL name VAL loreal paris mat ruj color riche addiction lipstick mahogandy study	1
COL name VAL loreal paris kaya kalemi brod artist high contour cool brown	COL name VAL lorsal paris les chocolate likit mat ruj r dose of coca	0
COL name VAL loreal paris infaillible gel arayon goz kalemi super cooper bakir	COL name VAL loreal paris kahverengi eye lider infaillible gel arayon cooper	1
COL name VAL loreal paris infallible super grip primer	COL name VAL loreal paris infallible super grip primer	1
COL name VAL lorsal paris infaillible burnu rose lip paint lolita	COL name VAL lorsal paris superliler black lacquer waterproof eye lider siyah	0
COL name VAL loreal paris ruj kalem mat lip arayon sweet and salt	COL name VAL loreal paris ruj kalem mat lip arayon sweet and salt	1
COL name VAL loreal paris brod game night plumpandset mavimsi koyu gri kaya copper nuances maskara	COL name VAL lorsal paris bambi eye oversized ceylan gaz etkili maskara siyah	0
COL name VAL loreal paris les chocolate ultra higlightonpoint likit fruit mint rougerayonnant	COL name VAL lorsal paris true match bakam yapan fondoten r rose belge	0
COL name VAL loreal paris lorsal true match bakam yapan fondoten r rose ivory ml	COL name VAL loreal paris true match nude serum fondoten very light	0
COL name VAL loreal paris brod m nude ivory plump and ureme cup dolgun garanam veren kaya sa	COL name VAL loreal paris brillant signature plump in glass ruj i inflate	0
COL name VAL lorsal paris infaillible h concealer pomada kapatacak medium koyu ton	COL name VAL loreal paris suya dayanakla siyah eye lider super black lacquer waterproof ml	0
COL name VAL loreal paris stick aydanlataca infaillible shaping drypetal is nocolor fdddc	COL name VAL lorsal paris infaillible nudist eye paint	0
COL name VAL lorsal paris true match maturu fondoten serum derincikolata nsbreeze	COL name VAL loreal paris miceller makyaj temizleme suyu ml	0
COL name VAL loreal paris color riche nude thrill addiction mata ocean wave moka acikfildisi	COL name VAL lorsal paris infaillible tam yaze uygulanabilir kapatacak ivory	0
COL name VAL lorsal paris infaillible tam yaze uygulanabilir kapatacak m creama belge	COL name VAL lorsal paris infaillible h mat fondoten belge dore	0
COL name VAL loreal paris waterproof arayon eye lider navy	COL name VAL loreal paris infallible waterproof gel arayon eye lider navy life	1
COL name VAL loreal paris suya dayanakla siyah eye lider super black lacquer waterproof ml	COL name VAL loreal paris kontar paleti infallible sculpt contouring palette mediumdark	0
COL name VAL loreal para ruj lap paint metalla lolita	COL name VAL loreal paris ruj infallible sexy bal go pretty or home	0
COL name VAL loreal paris telescopic maskara siyah li	COL name VAL loreal paris telescopic maskara siyah li	1
COL name VAL loreal paris uzun sare kalaca fondoten infallible h foundation belge dore ml	COL name VAL loreal paris lorsal infaillible step saat kalaca likit ruj and bal metro prof rose	0
COL name VAL lorsal paris yan red orangezest maskara	COL name VAL loreal paris mat eye lider signature makron	0
COL name VAL loreal paris likit stormwatch kullu kahve under the spotlight signature caribbean i magnetine	COL name VAL loreal paris ceylan gaz etkili ekstra siyah maskaramaybelline kanal kalemi	0
COL name VAL loreal paris kontur paleti infallible sculpt contouring palette medium / dark	COL name VAL loreal paris infaillible sculpt palette kontur paleti medium dark	1
COL name VAL loreal paris brod redstiletto plumpandset g kaya moon grey maskara belge sale ortaton	COL name VAL loreal paris kontar paleti infallible sculpt contouring palette mediumdark	0
COL name VAL loreal paris kapatacak true match concealer ivory	COL name VAL lorsal paris contour kol r portofino blue gaz kalemi	0
COL name VAL loreal paris pudra true match power n belge	COL name VAL lorsal paris colour riche extraordinaire ruj d rose finale	0
COL name VAL loreal paris paradise extatic siyah maskara	COL name VAL loreal paris gaz fara infallible eyeshadow paint iconic silver	0
COL name VAL loreal paris unbelieva brod long casting gel dark brunette	COL name VAL loreal paris air mega volume maskara saate kadar kalaca ekstra siyah	0
COL name VAL loreal paris les chocolate likit smokedwood private jet volupto m nlightbeige	COL name VAL loreal paris true match bakam yapan fondoten n porcelaan	0
COL name VAL loreal paris infaillible tum yuze uygulanabilir kapatici ivory	COL name VAL loreal paris infaillible tum yuze uygulanabilir kapatici ivory	1
COL name VAL loreal paris kadin pembe dolgunlastirici mat ruj	COL name VAL loreal paris color riche plump sine ruj pitaya	1
COL name VAL loreal paris unlimited siyah maskara ali set paket ( x adet )	COL name VAL loreal paris unlimited siyah maskara ali set paket ( x adet )	1
COL name VAL lorsal paris true match bakam yapan fondoten d kahvetonlarimat cappuccano	COL name VAL loreal paris bambi eye ceylan gaz etkili suya dayanakla siyah maskara	0
COL name VAL loreal paris infaillible h mattecocoa cover yaksek kapatacak touch of apricot tea rose fondoten	COL name VAL loreal paris infaillible mat lip arayon kalem ruj hot apricot	0
COL name VAL loreal paris saat kalici ruj infaillible rouge permanant blush	COL name VAL loreal paris infaillible h ruj permanant blush nude	1
COL name VAL loreal paris infaillible h concealer pomada kapatacak acikgulkurusu	COL name VAL lorsal paris infaillible gel arayon gaz kalemi ive got the blue mavi	0
COL name VAL loreal paris infaillible gel arayon h eye lider blue	COL name VAL loreal paris mavi eye lider infaillible gel arayon blue	1
COL name VAL loreal paris les macarons ultra mat likit ruj mademoise	COL name VAL loreal paris likit mat ruj les macarons ultra liquid lipstick mademoiselle mango	1
COL name VAL loreal paris mat gri superliler matic tupe grey	COL name VAL loreal paris super lider gelmatic tupe grey gri goz kalemi	1
COL name VAL loreal paris infaillible h fondoten honey	COL name VAL loreal paris infaillible h fondoten honey	1
COL name VAL loreal paris softheart color riche free the festiveburgundy lirenk judgment	COL name VAL lorsal paris infaillible tam yaze uygulanabilir kapatacak eggshell	0
COL name VAL lorsal paris color riche saten bitiayliruj lovers blush jade something	COL name VAL lorsal paris true match bakam yapan fondoten d golden sand	0
COL name VAL lorsal paris true match bakam yapan fondoten r kahve altuni bronz kirmizi kor mm	COL name VAL lorsal paris paradise orman meyvesi kokulu mor maskara	0
COL name VAL lorsal paris color riche ruj exclusive reis los pure red	COL name VAL lorsal paris infaillible h fondoten golden belge	0
COL name VAL loreal paris les macarons likit mat ruj guava rush	COL name VAL loreal paris les macarons likit mat ruj guava rush	1
COL name VAL loreal paris ruj infallible sexy bal yala yol	COL name VAL loreal paris likit mat ruj les macarons ultra liquid lipstick framboise frenzy	0
COL name VAL loreal paris likit mat ruj rouge signature i achieve	COL name VAL loreal paris likit mat ruj rouge signature i achieve	1
COL name VAL loreal paris mat signature eye lider emeraude yesil	COL name VAL loreal paris mat signature eye lider emeraude yesil	1
COL name VAL loreal paris infaillible eye paint gaz fara irresistible	COL name VAL lorsal paris brod artist high contour bony esmer	0
COL name VAL loreal paris telescopic carbon extra black maskara siyah	COL name VAL loreal paris fondoten true match golden amber	0
COL name VAL lorsal paris color riche very cherry addiction starryrose kahverengi bordo clutch just friends	COL name VAL loreal paris saat kalaca ruj infaillible	0
COL name VAL loreal paris goz fari color riche quad e liglas cheri	COL name VAL loreal paris goz fari color riche quad e liglas cheri	1
COL name VAL lorsal paris bonjour nudista aydanlar veren renkli nemlendirici medium dark koyu ton	COL name VAL loreal paris anfaillible eye lider stay blue	0
COL name VAL loreal paris color riche free the nudes ruj no doubt	COL name VAL loreal paris color riche free the nudes ruj no doubt	1
COL name VAL lorsal paris color riche ruj exclusive reis eva pure red	COL name VAL loreal paris bronz please bronzlaaytaraca pudra amali	0
COL name VAL lorsal paris unlimited rose clair maskara	COL name VAL loreal paris true match bakam yapan fondoten n belge	0
COL name VAL lorsal paris brod seffaf renksiz velvbear kaya pomada k grk hip n happy	COL name VAL lorsal paris paradise suya dayanakla siyah maskara	0
COL name VAL loreal paris stick fondoten infaillible longwear shaping foundation sl chocolate parlakseftali	COL name VAL loreal paris ceylan gaz etkili maskara siyah mabelline newyork kanal kalem	0
COL name VAL lorsal paris infaillible tam yaze uygulanabilir kapatacak walnut	COL name VAL loreal paris saat kalaca kalem no	0
COL name VAL loreal paris stick aydanlataca infaillible shaping en acik is steel gray	COL name VAL lorsal paris color riche plump and sine ruj nektarine	0
COL name VAL loreal paris gaz kalemi no portofino mavisi	COL name VAL loreal paris ruj kalem mat lap arayon karamel blondie	0
COL name VAL loreal paris les macarons likit mat ruj infinite spice	COL name VAL loreal paris likit mat ruj les macarons ultra liquid lipstick infinite spice	1
COL name VAL loreal paris infaillible more tan concealer kapatacak lin	COL name VAL lorsal paris rouge signature likit mat ruj i represent	0
COL name VAL lorsal paris brillant signature plump in glass taslidesenli i tatli mavi	COL name VAL lorsal paris color riche mat addiction ruj bronz sautoir kahverengi	0
COL name VAL lorsal paris les macarons likit darkbrunette c medium with warm bronz delight rush	COL name VAL lorsal paris la petite far paleti maximalist	0
COL name VAL loreal paris infaillible h sumptuous gold cover yaksek kapatacak fondoten warm sand w mat bordo	COL name VAL loreal paris mat eye lider signature emeraude	0
COL name VAL loreal paris true match bakam yapan fondoten n belge	COL name VAL lorsal paris infaillible h mat cover yaksek kapatacak fondoten rose ivory	0
COL name VAL loreal paris volume million lashes maskara black	COL name VAL loreal paris kahverengi gaz kalemi contour kohl brown	0
COL name VAL lorsal paris true match bakam yapan fondoten n nocolor bcbdd	COL name VAL lorsal paris infaillible shaping stick fondoten natural rose	0
COL name VAL loreal paris stick aydinlatici infaillible shaping oh my jewelsi	COL name VAL loreal paris stick aydinlatici infaillible shaping oh my jewelsi	1
COL name VAL loreal paris dudak kalemi infaillible lip pencila my is are insured rosefome	COL name VAL lorsal paris infaillible sexy bal ruj carpe die	0
COL name VAL loreal paris lorsal infaillible tam yaze uygulanabilir kapatacak honey	COL name VAL lorsal paris rouge signature parisien sunset likit mat ruj i led	0
COL name VAL loreal paris les chocolate ultra jl charleston grey likit expressize wn ecre redforever toth	COL name VAL lorsal paris infaillible lip paint likit ruj mat king pink	0
COL name VAL loreal paris dudak kalemi infaillible lip bencil on a mission with the coralcaress	COL name VAL loreal paris uzun sare kalaca fondoten infallible h foundation belge dore ml	0
COL name VAL loreal paris brod artist plump set renkli ka sabitleyici maskara dark brunette	COL name VAL loreal paris brod artist plump set dolgun gorunum veren kassa	1
COL name VAL loreal paris ekstra pudra pembe tonlari likit eye lider superliler tattoo signature	COL name VAL lorsal paris infaillible tam yaze uygulanabilir kapatacak ivory	0
COL name VAL lorsal paris color riche nocolor eda addiction noir minimal mat auroraborealis tenrengivekarisikmor	COL name VAL lorsal paris color riche sine naked tane ruj belge in the city nude	0
COL name VAL loreal paris brod artist high contour bony esmer	COL name VAL loreal paris brod artist high contour bony esmer	1
COL name VAL loreal paris true match bakam yapan fondoten n sale sand	COL name VAL loreal paris allak true match le blush no peach	0
COL name VAL lorsal paris true match bakam yapan fondoten d vallauris sunset kiss	COL name VAL loreal paris siyah maskara falso lash butterfly effect intenza	0
COL name VAL loreal paris mat ruj color riche addiction bronz sautoir	COL name VAL loreal paris lorsal true match bakam yapan fondoten golden sand	0
COL name VAL loreal paris true match fondoten n maelhoney	COL name VAL lorsal paris color riche mat addiction ruj voodoo mor	0
COL name VAL lorsal paris infaillible h fondoten bronz glitter fc victory of black	COL name VAL lorsal paris brod artist paradise kaya pomada brunette kumral	0
COL name VAL loreal paris nude magique cushion fondoten vanilla	COL name VAL loreal paris nude magique cushion fondoten vanilla	1
COL name VAL lorsal paris color petro tekli gaz fara powerhouse	COL name VAL lorsal paris mega volume collagene h siyah maskara	0
COL name VAL loreal paris ruj kalem mat lip arayon mon cinnamom	COL name VAL loreal paris infaillible mat lip arayon kalem ruj mon cinnamon	1
COL name VAL loreal paris pudra true match power c broonze icin nocolor aref	COL name VAL loreal paris true match bakam yapan fondoten r rose belge	0
COL name VAL loreal paris uzun sare kalaca fondoten infallible h foundation honey ml	COL name VAL loreal paris ruj lip paint metallik lolita	0
COL name VAL lorsal paris true match bakam yapan fondoten d narcissus straight red	COL name VAL loreal paris true match bakam yapan fondoten n ivory	0
COL name VAL loreal paris true match nude serum fondoten light medium farajsa	COL name VAL lorsal paris color riche plump and sine ruj guava	0
COL name VAL loreal paris lorsal true match bakam yapan fondoten n belge	COL name VAL lorsal paris infallible sale sand fondoten	0
COL name VAL lorsal paris color frencbeyazi tekli gaz fara orta bej	COL name VAL loreal paris true match bakam yapan fondoten n belge	0
COL name VAL loreal paris air volume mega hacim veren gde maskarabrow ekru skinny define kaya kalemi organizer	COL name VAL loreal paris dudak kalemi infaillible lip bencil nude ist	0
COL name VAL loreal paris ruj lip paint metallik dixie	COL name VAL loreal paris true match bakam yapan fondoten golden ivory	0
COL name VAL loreal paris color riche x balmain get off hamrenk nudeflirt	COL name VAL loreal paris lorsal true match nude fondoten serum very light	0
COL name VAL lorsal paris true match bakam yapan fondoten d golden belge	COL name VAL lorsal paris color riche ruj d orange after party	0
COL name VAL loreal paris infaillible nudist eye paint cocky bosque	COL name VAL loreal paris infaillible nudist eye paint cocky bosque	1
COL name VAL loreal paris infaillible shaping stick fondoten belge dore	COL name VAL loreal paris stick fondoten belge dore	1
COL name VAL lorsal paris infaillible h fondoten true belge	COL name VAL lorsal paris les chocolate likit mat ruj volupto chico	0
COL name VAL loreal paris siyah bambi eye oversized ceylan gaz etkili maskara	COL name VAL loreal paris likit mat ruj rouge signature savar	0
COL name VAL loreal paris ruj color riche free the nudes no obstacles	COL name VAL loreal paris color riche free the nudes ruj no obstacles	1
COL name VAL lorsal paris true match bakam yapan fondoten r metalik bronz seffaftenrengi	COL name VAL loreal paris infaillible mat lip arayon kalem ruj karamel rebel	0
COL name VAL loreal paris lorsal true match nude fondoten serum very light	COL name VAL lorsal paris rouge signature empowereds likit mat ruj honored	0
COL name VAL loreal paris color riche ruj pink anac	COL name VAL loreal paris color riche ruj pink anac	1
COL name VAL loreal paris kahverengi eye lider infaillible gel arayon cooper	COL name VAL lorsal paris brillant signature plump in glass ruj i inflate	0
COL name VAL lorsal paris infaillible kazaraklak giderici makyaj baza	COL name VAL loreal paris stick allak infaillible shaping nude in rose	0
COL name VAL lorsal paris true match allak nektarine	COL name VAL loreal paris kadar pembe likit aydanlataca blow mon amour droplet high light n melon dollar baby	0
COL name VAL loreal paris blackestblack eye lider smokinsime superliler toprak	COL name VAL loreal paris suya dayanakla siyah eye lider super black lacquer waterproof ml	0
COL name VAL loreal paris likit nbrightorange mat revolution sunsetbreeze signature fairycharms i scintillate	COL name VAL loreal paris true match bakam yapan fondoten n ivory	0
COL name VAL loreal paris true match bakam yapan fondoten n ivory	COL name VAL lorsal paris rouge signature metallik likit ruj i voodoo	0
COL name VAL loreal paris color riche kgold woman pl luxury white nocolor baeze balmain instinct	COL name VAL loreal paris stick allak infaillible shaping nude in rose	0
COL name VAL lorsal paris simli haki signature eye lider dc nstylishcarmine yayil	COL name VAL loreal paris eye lider smokinsime superliler tupe smoke	0
COL name VAL lorsal paris infaillible magic esence dropsu likit makyaj baza	COL name VAL lorsal paris infaillible tam yaze uygulanabilir kapatacak vanilla	0
COL name VAL loreal paris true match nude fondoten serum very light	COL name VAL loreal paris true match nude fondoten serum very light	1
COL name VAL loreal paris likit mat ruj les macarons ultra liquid lipstick framboise frenzy	COL name VAL loreal paris likit mat ruj les macarons ultra liquid lipstick framboise frenzy	1
COL name VAL loreal paris les chocolate ultra naked deep dark likit c medium cool oh my chou	COL name VAL loreal paris ruj color riche sine naked tas blow you nude	0
COL name VAL loreal paris infallible longwear lip lider nudeist	COL name VAL loreal paris infallible longwear lip lider nudeist	1
COL name VAL loreal paris likit mat ruj les macarons ultra liquid lipstick blackcurrant crush	COL name VAL loreal paris infaillible fresh wear c vitaminli fondoten d rose ivory	0
COL name VAL loreal paris color riche fr nd volume cherry no brun rose say yes nonchalant	COL name VAL lorsal paris ait fazla miceller kusursuz makyaj temizleme suyu	0
COL name VAL loreal paris kahverengi eye lider infallible style h chocolate addict	COL name VAL loreal paris saat kalici kalem no	1
COL name VAL lorsal paris air mega volume maskara saate kadar kalaca ekstra siyah	COL name VAL loreal paris le diner signature mavi gaz kalemi	0
COL name VAL loreal paris infaillible h mat fondoten belge evlat	COL name VAL loreal paris infaillible h mat fondoten belge evlat	1
COL name VAL loreal paris les chocolate likit mat ruj yum	COL name VAL loreal paris les chocolate ultra mat likit ruj yum	1
COL name VAL loreal paris color riche soft terracotta woman blue raspberry simli kirmizi glamazone	COL name VAL lorsal paris infaillible h mat cover yaksek kapatacak fondoten golden belge	0
COL name VAL loreal paris infaillible resurfacing gozenek gizleyici ve parazsazleaytirici makyaj baza	COL name VAL lorsal paris mega glass lip whos the boss	0
COL name VAL lorsal paris color simplytaupe tekli gaz fara ruthless	COL name VAL loreal paris true match bakam yapan fondoten n ivory	0
COL name VAL loreal paris true match nude fondoten serum very light	COL name VAL loreal paris true match nude serum fondoten very light	1
COL name VAL lorsal paris infaillible h fondoten freni	COL name VAL loreal paris true match kapatacak dw golden amber	0
COL name VAL loreal paris ruj color riche sine addiction lipstick yol	COL name VAL lorsal paris color riche intense volume mat ruj nude independent	0
COL name VAL loreal paris color riche intense volume mat ruj coral irreverent	COL name VAL loreal paris color riche intense volume mat ruj coral irreverent	1
COL name VAL loreal paris miceller makyaj temizleyici paradise intense maskara seti	COL name VAL lorsal paris color queen tekli gaz fara influence	0
COL name VAL loreal paris rouge signature likit mat ruj i done	COL name VAL loreal paris rouge signature likit mat ruj i done	1
COL name VAL loreal paris fondoten sugar biscuits visible lift	COL name VAL loreal paris ruj lip paint metallik lolita	0
COL name VAL lorsal paris les macarons likit tinkle keepitfun framboise frenzy	COL name VAL lorsal paris infaillible h fondoten sand	0
COL name VAL loreal paris infallible longwear lip lider stay ultraviolet	COL name VAL loreal paris true match bakam yapan fondoten vanilla	0
COL name VAL lorsal paris brod c deep with warm bronz high contour puskin koyueflatun	COL name VAL lorsal paris infaillible eye paint gaz fara irresistible rose	0
COL name VAL loreal paris ruj color riche privye nudes juliannem nude	COL name VAL loreal paris ruj color riche privye nudes juliannem nude	1
COL name VAL loreal paris true match kapatacak n creama belge	COL name VAL lorsal paris true match bakam yapan fondoten rck golden ivory	0
COL name VAL lorsal paris true match prestige pudra n vanilla	COL name VAL loreal paris jel siyah eye lider gel intenza h r pure black	0
COL name VAL loreal paris ruj lip paint metallik dixie	COL name VAL loreal paris tekli gaz fara color queen mono eyeshadow unsurpassed	0
COL name VAL loreal paris lash chocolate fonde midnightstar d silver ekstra hat s peachi maskara	COL name VAL loreal paris lorsal infaillible h fresh wear c vitaminli fondoten rose belge	0
COL name VAL loreal paris ruj color riche plump and sine lipstick guava	COL name VAL loreal paris color riche plump sine ruj guava	1
COL name VAL loreal paris karl lagerfeld collection mat eye lider chic rose silver	COL name VAL loreal paris karl lagerfeld collection mat eye lider chic rose silver	1
COL name VAL loreal paris infaillible h fresh wear fondoten vanilla ml	COL name VAL loreal paris kaya kalemi brod artist pert warm bruce	0
COL name VAL loreal paris likit kompakt fondoten nude magique liquid cushion foundation vanilla	COL name VAL loreal paris ruj lip paint metallik lolita	0
COL name VAL loreal paris kaya kalemi brod artist high contour warm brown	COL name VAL loreal paris lorsal bronz to paradise mat bronzlaaytaraca pudra ml baby one more tan	0
COL name VAL loreal paris neutral blonde dixie dust color riche who run the world addiction lipstick n mediumwithneutral	COL name VAL lorsal paris infaillible lip paint likit ruj mat tanzerine vertigo	0
COL name VAL loreal paris rouge signature likit mat ruj	COL name VAL loreal paris rouge signature likit mat ruj	1
COL name VAL loreal paris dudak kalemi infaillible lip bencil stay ultraviolet	COL name VAL loreal paris true match bakam yapan fondoten creama belge	0
COL name VAL loreal paris riche mat addiction ruj voodoo	COL name VAL loreal paris color riche mat addiction ruj voodoo mor	1
COL name VAL loreal paris infaillible lip paint likit ruj lacquer red fiction	COL name VAL loreal paris likit mat ruj infallible lip paint lacquer red fiction	1
COL name VAL loreal paris likit mat ruj rouge signature enjoy	COL name VAL loreal paris rouge signature likit mat ruj i enjoy	1
COL name VAL lorsal paris true match bakam yapan fondoten d golden ivory	COL name VAL lorsal paris infaillible tam yaze uygulanabilir kapatacak ivory	0
COL name VAL loreal paris kadar no color ruj	COL name VAL loreal paris rouge signature parisien sunset likit mat ruj	0
COL name VAL loreal paris kahverengi ka kalemi brod artist shapen brunette	COL name VAL loreal paris kahverengi ka kalemi brod artist shapen brunette	1
COL name VAL lorsal paris superliler gel matic	COL name VAL lorsal paris true match bakam yapan fondoten creama belge	0
COL name VAL loreal paris lorsal true match bakam yapan fondoten d golden sand	COL name VAL lorsal paris true match bakam yapan fondoten d golden sand	0
COL name VAL lorsal paris infallible lip paint nocolor dabaka koyu sari dead is	COL name VAL lorsal paris true match pudra	0
COL name VAL loreal paris lightivory signature parisien asif i care likit sexshuffle nektarin siyah cicekli lead	COL name VAL lorsal paris true match kapatacak rc rose belge	0
COL name VAL lorsal paris infaillible dudak kalemi bronz touch with the queen b maviyesil	COL name VAL lorsal paris true match prestige pudra n vanilla	0
COL name VAL loreal paris unlimited siyah maskara ali set	COL name VAL loreal paris unlimited siyah maskara ali set	1
COL name VAL loreal paris true match pudra n belge	COL name VAL loreal paris pudra true match power r / c rose vanilla	1
COL name VAL loreal paris likit aydinlatici blow mon amour droplet high light bronz in love	COL name VAL loreal paris blow mon amour likit aydinlatici bronz in love	1
COL name VAL loreal paris maskara telescopic blacka	COL name VAL loreal paris true match bakam yapan fondoten ivory	0
COL name VAL loreal paris infaillible dudak kalemi gone with the nude	COL name VAL loreal paris dudak kalemi infaillible lip bencil gone with the nude	1
COL name VAL loreal paris true match bakim yapan fondoten n truffe	COL name VAL loreal paris true match bakim yapan fondoten n truffe	1
COL name VAL lorsal paris superliler perfect slim siyah eye lider	COL name VAL loreal paris likit mat ruj les macarons ultra liquid lipstick blackcurrant crush	0
COL name VAL loreal paris bambi eye falso lash ceylan goz etkili ekstra siyah maskara	COL name VAL loreal paris bambi eye extra black ceylan goz etkili maskara ekstra siyah	1
COL name VAL lorsal paris true match kapatacak rc rose belge	COL name VAL loreal paris ruj labial color riche careyse lipstick cheeky macenta	0
COL name VAL loreal paris kahverengi les chocolate ultra mat liquid lipstick likit ruj	COL name VAL loreal paris les chocolate likit mat ruj ginger bomb	1
COL name VAL loreal paris kaya maskarasi brod asist pluto and classic ruby berry elidir	COL name VAL loreal paris ruj color riche free the nudes no cage	0
COL name VAL loreal paris ruj color riche sine naked tas blow you nude	COL name VAL loreal paris color riche sine naked tane ruj blow you nude	1
COL name VAL loreal paris dudak kalemi infaillible lip bencil ivoteforme farklirenk	COL name VAL loreal paris stick allak infaillible shaping sexy flash	0
COL name VAL lorsal paris true match bakam yapan fondoten d lavender love major magnete	COL name VAL loreal paris lorsal infaillible tam yaze uygulanabilir kapatacak honey	0
COL name VAL loreal paris careyse lipstick ruj	COL name VAL lorsal paris rouge signature likit mat ruj i enjoy	0
COL name VAL loreal paris telescopic maskara goz makyaj seti	COL name VAL loreal paris telescopic maskara goz makyaj seti	1
COL name VAL loreal paris camel color riche sine addiction lipstick kirmizi lacivert	COL name VAL loreal paris kaya kalemi and aydanlataca brunette	0
COL name VAL loreal paris lorsal volumissime royale x maskara siyah adet set	COL name VAL lorsal paris infaillible eye paint gaz fara r goldeneye	0
COL name VAL loreal paris unbelieva brod uzun sare kalaca kaya jeli bony	COL name VAL lorsal paris color riche sine naked tane ruj blow you nude	0
COL name VAL loreal paris lorsal true match bakam yapan fondoten r rose sand	COL name VAL loreal paris stick aydanlataca infaillible shaping gold is cold	0
COL name VAL lorsal paris infaillible h murdum kahve cover yaksek kapatacak fondoten grs cashmere rose	COL name VAL loreal paris emotions of nu allak far paleti sky maskara seti	0
COL name VAL lorsal paris bambi eye ceylan gaz etkili maskara siyah ml	COL name VAL lorsal paris infaillible h mat cover yaksek kapatacak fondoten ml rose vanilla	0
COL name VAL loreal paris infaillible h fondoten belge dore	COL name VAL loreal paris infaillible h fondoten belge dore	1
COL name VAL loreal paris falso lash wings maskara ntenza ml siyah	COL name VAL loreal paris siyah maskara falso lash butterfly effect intenza	1
COL name VAL loreal paris allak true match porquerolles sardunya kirmizi ortaton metalik french luminous satin	COL name VAL loreal paris bambi eye falso lash ceylan gaz etkili ekstra siyah maskara	0
COL name VAL lorsal paris infallible waterproof gel arayon eye lider golden woman	COL name VAL loreal paris color riche plump and sine ruj n nektarine	0
COL name VAL lorsal paris extraordinaire lightwithneutral	COL name VAL loreal paris siyah smokinsime superliler black	0
COL name VAL loreal paris infaillible sexy bal ruj go pretty or home	COL name VAL loreal paris ruj infallible sexy bal go pretty or home	1
COL name VAL loreal paris color riche sine addiction lipstick map to nirvana teknon	COL name VAL loreal paris telescopic carbon extra black maskara siyah	0
COL name VAL loreal paris ruj color riche sine naked tas shot of sun nude	COL name VAL loreal paris true match bakam yapan fondoten golden sand	0
COL name VAL loreal paris telescopic carbon black maskara siyah	COL name VAL loreal paris infaillible lip paint likit ruj mat wuthering purple	0
COL name VAL loreal paris kaya kalemi brod artist high contour warm blonde	COL name VAL loreal paris mat ruj color riche addiction storm	0
COL name VAL loreal paris likit ruj color riche l extraordinaire lipstick ruby opera	COL name VAL loreal paris likit ruj color riche l extraordinaire lipstick ruby opera	1
COL name VAL loreal paris ruj color riche lipstick oud obsession	COL name VAL loreal paris color riche ruj oud obsession	1
COL name VAL loreal paris infaillible h fleurfatale cover yaksek kapatacak fondoten	COL name VAL lorsal paris infaillible mat lip arayon kalem ruj karamel rebel paket x	0
COL name VAL loreal paris true match metal spice up clear w soft rose in mor kirmizi pembe	COL name VAL lorsal paris la petite far paleti stilist	0
COL name VAL loreal infaillable lipstick step incessant	COL name VAL loreal paris infaillible step saat kalici likit ruj bal incessant russel	1
COL name VAL loreal paris true match gaz kremi iceren kapatacak josey for you strawberrykissed	COL name VAL loreal paris lorsal superliler gel intenza siyah eye lider	0
COL name VAL lorsal paris infaillible h fondoten all powerful red brighteler melon	COL name VAL loreal paris mat eye lider signature ink	0
COL name VAL loreal paris kapatici true match concealer r / c rose belge	COL name VAL loreal paris true match kapatici r / c rose belge	1
COL name VAL lorsal paris mat signature eye lider burgundy bordo	COL name VAL lorsal paris color riche ruj oud obsession	0
COL name VAL loreal paris color riche x balmain collection rock woman mat ruj freedom	COL name VAL loreal paris color riche x balmain collection rock woman mat ruj freedom	1
COL name VAL loreal paris infaillible mat lip arayon kalem ruj brulae everyday	COL name VAL lorsal paris rouge careyse ruj ml lovely rose	0
COL name VAL loreal paris kahverengi goz kalemi contour kol kanal espresso	COL name VAL loreal paris color riche lekhol goz kalemi pure espresso	1
COL name VAL lorsal paris color riche golden peach addiction hot tahiti cafeconleche sautoir oh my chou	COL name VAL lorsal paris true match bakam yapan fondoten d golden sand	0
COL name VAL loreal paris les chocolate ultra mat likit ruj oh my chow	COL name VAL loreal paris les chocolate likit mat ruj oh my chow	1
COL name VAL loreal paris infaillible h fresh wear pudra fondoten vanilla	COL name VAL loreal paris chrome neon lanet electric zoo	0
COL name VAL lorsal paris infaillible h fondoten amber	COL name VAL lorsal paris infaillible h mat cover yaksek kapatacak fondoten rose porcelain	0
COL name VAL loreal paris true match fondoten rck ivory rose	COL name VAL loreal paris koyu siyah maskara lash architects midnight black	0
COL name VAL loreal paris color riche le sourcil kas kalemi golden brown	COL name VAL loreal paris color riche le sourcil kas kalemi golden brown	1
COL name VAL loreal paris color riche intense volume mat ruj nude admirable ayna	COL name VAL loreal paris color riche intense volume mat ruj nude admirable ayna	1
COL name VAL loreal paris khartoum maskara sevgililer ve kadinlar gana azel	COL name VAL loreal paris lorsal lash paradise siyah maskara	0
COL name VAL loreal paris fondoten true match foundation d golden belge ml	COL name VAL lorsal paris infaillible h mat cover yaksek kapatacak fondoten natural rose	0
COL name VAL loreal paris mega glass lip smokeme up	COL name VAL loreal paris ruj infallible mega glass smokeme up	1
COL name VAL loreal volume million lashes maskara chocolate au ait rose medium with neutral	COL name VAL lorsal paris brod artist pert no bony	0
COL name VAL loreal paris lorsal infaillable automatic jel gaz kalemi khartoum	COL name VAL loreal paris likit makyaj baza infaillible magic esence dropsu	0
COL name VAL loreal paris falso lash telescopic fiber maskara ml	COL name VAL loreal paris falso lash telescopic fiber maskara ml	1
COL name VAL loreal paris lorsal bambi eye ceylan gaz etkili maskara siyah	COL name VAL loreal paris ruj color riche lipstick pink anac	0
COL name VAL loreal paris super lider silkisime mavi	COL name VAL loreal paris mavi goz kalemi super lider silkisime	1
COL name VAL loreal paris red seventies sharp black pearl color riche inen nutrenk addiction lipstick gumusaltin clutch	COL name VAL loreal paris mor eye lider infallible gel arayon purple	0
COL name VAL lorsal paris superliler black lacquer waterproof eye lider siyah	COL name VAL lorsal paris true match kapatacak golden amber	0
COL name VAL loreal paris suya dayanakla red lip eye lider super smeraldgreen lacquer waterproof bahama brown	COL name VAL lorsal paris brod artist paradise kaya pomada warm blonde sarlayan	0
COL name VAL lorsal paris color riche foreverstrikin addiction kirmizi uzum rengi stone clutch r gvm	COL name VAL loreal paris color riche arayon lider blush fever x	0
COL name VAL loreal paris suya dayanakla siyah maskara unlimited very different waterproof black	COL name VAL lorsal paris mega glass lip you know loveme	0
COL name VAL lorsal paris infaillible h fondoten radiant honey	COL name VAL loreal paris dudak kalemi color riche arayon lider scarlet rouge	0
COL name VAL loreal paris lash sensationsal yelpaze etkili maskara seftalitonlari koyu soguk mor	COL name VAL loreal paris true match nude serum fondoten light	0
COL name VAL loreal paris likit no nar sarabi color riche lextraordinaire lipstick lie devin drama	COL name VAL lorsal paris brod artist micro tattoo brunette kumral	0
COL name VAL loreal paris infallible super grip primer	COL name VAL loreal paris rouge signature empowereds likit mat ruj empowered	0
COL name VAL loreal paris kadar orange magique ruj	COL name VAL lorsal paris true match bakam yapan fondoten belge	0
COL name VAL loreal paris infaillible resurfacing gozenek gizleyici ve parazsazleaytirici baz	COL name VAL loreal paris miceller makyaj temizleme suyu normalden ve karmaya hassas ciltler iain ml	0
COL name VAL loreal paris true match bakim yapan fondoten r rose amber	COL name VAL loreal paris true match bakim yapan fondoten r rose amber	1
COL name VAL loreal paris color rica ultra normalden golden rose yesil kahve moulin rouge hesitation	COL name VAL loreal paris true match bakam yapan fondoten n creama belge	0
COL name VAL loreal paris goz fari infallible eyeshadow paint breathtaking	COL name VAL loreal paris goz fari infallible eyeshadow paint breathtaking	1
COL name VAL loreal paris infaillible h mat cover amber doregolden fondoten ml	COL name VAL loreal paris lorsal infaillible d step saat kalaca likit ruj and bal toujours coffee	0
COL name VAL loreal paris likit aydinlatici blow mon amour droplet high light	COL name VAL loreal paris likit aydinlatici blow mon amour droplet high light	1
COL name VAL lorsal paris color riche dudak kalemi bois de rose nude	COL name VAL loreal paris infaillible step saat kalaca likit ruj and bal toujours teaberry	0
COL name VAL lorsal paris color queen tekli gaz fara ferocious	COL name VAL loreal paris mat ruj color riche addiction storm	0
COL name VAL loreal paris kapatacak true match concealer rc brief encounter tanganyka	COL name VAL lorsal paris infaillible lip paint likit ruj mat king pink	0
COL name VAL loreal paris tekli goz fari color queen mono eyeshadow extraordinnaire	COL name VAL loreal paris tekli goz fari color queen mono eyeshadow extraordinnaire	1
COL name VAL lorsal paris audrey signature parisien greyglitter likit fusyatasli ruby crush i amade	COL name VAL loreal paris ruj color riche sine naked tas blow you nude	0
COL name VAL loreal paris telescopic maskara	COL name VAL loreal paris telescopic maskara	1
COL name VAL loreal paris infaillible h red brown wear pudra fondoten nocolor dodd	COL name VAL loreal paris lash paradise intense black ekstra siyah maskara li set ve ayna	0
COL name VAL loreal paris kapatici true match concealer n ivory	COL name VAL loreal paris true match kapatici n ivory	1
COL name VAL loreal paris kirmizi sivri mm signature empowereds likit hotgossip dusty pink flamenko red	COL name VAL lorsal paris cast magic bb krem medium light	0
COL name VAL lorsal paris infaillible h fondoten nocolor bddbd electric blue	COL name VAL loreal paris mat ruj color riche addiction amulet	0
COL name VAL loreal paris les chocolate likit mat ruj box of chocolatem	COL name VAL loreal paris true match foundation golden sand fondoten sangeri seti	0
COL name VAL loreal paris kadar pembe dolgunlaaytaraca mat ruj	COL name VAL loreal paris ruj color riche free the nudes no lies	0
COL name VAL loreal paris likit mat ruj les macarons ultra liquid lipstick guava rush	COL name VAL loreal paris infaillible tam yaze uygulanabilir kapatacak ivory	0
COL name VAL loreal paris mat ruj color riche addiction lava	COL name VAL loreal paris mat ruj color riche addiction lava	1
COL name VAL lorsal paris g ters lechles signature likit light chantilly notr cok acik ten nocolor daa i achieve	COL name VAL loreal paris infaillible h mat cover yaksek kapatacak fondoten natural rose	0
COL name VAL loreal paris push the limit soft pink brown bazla sharp eb lila desenli kingofthebets	COL name VAL lorsal paris infaillible h mat cover yaksek kapatacak fondoten rose vanilla	0
COL name VAL loreal paris suya dayanakla jl maskara unlimited very different waterproof my eter	COL name VAL loreal paris true match bakam yapan fondoten r rose	0
COL name VAL loreal paris volume million lashes maskara beyaz kalin	COL name VAL loreal paris color riche saten bitiayli ruj seine sunset nude	0
COL name VAL lorsal paris color riche plump and sine ruj coconun	COL name VAL lorsal paris le diner signature gaz kalemi rouge noir angora	0
COL name VAL loreal paris likit kompakt fondoten nude magique liquid cushion foundation golden amber	COL name VAL loreal paris likit kompakt fondoten nude magique liquid cushion foundation golden amber	1
COL name VAL loreal paris infaillible mat lip arayon kalem ruj karamel rebel	COL name VAL loreal paris infaillible mat lip arayon kalem ruj karamel rebel	1
COL name VAL loreal paris pl ntenderbeige sexyred color riche say in rose addiction lipstick allfiredup b shortbread	COL name VAL loreal paris likit metalik ruj rouge signature metallik i magnetine	0
COL name VAL lorsal paris true match bakam yapan fondoten n vanilla	COL name VAL lorsal paris infaillible h fondoten rose belge	0
COL name VAL lorsal paris color rose pink tekli gaz fara charger	COL name VAL lorsal paris true match bakam yapan fondoten n belge	0
COL name VAL loreal paris kahverengi goz kalemi contour kohl brown	COL name VAL loreal paris contour kol goz kalemi brown	1
COL name VAL loreal paris mat ruj color riche addiction lipstick pink ready to we	COL name VAL lorsal paris infaillible h fresh wear pudra fondoten sand	0
COL name VAL lorsal paris color riche mat addiction ruj haute rouge karmasa	COL name VAL loreal infaillible h fresh wear pudra fondoten ml cashmere	0
COL name VAL loreal paris rouge signature lip hopper dudak parlatici ruj white gold	COL name VAL loreal paris rouge signature lip hopper dudak parlatici ruj white gold	1
COL name VAL loreal paris color queen tekli goz fari crownem	COL name VAL loreal paris color queen tekli goz fari crownem	1
COL name VAL loreal paris tekli gaz fara color queen mono eyeshadow on top	COL name VAL lorsal paris infaillible h fondoten true belge	0
COL name VAL loreal paris color riche plump sine ruj watermelon	COL name VAL loreal paris color riche plump sine ruj	1
COL name VAL loreal paris lorsal true match nude fondoten serum light medium	COL name VAL lorsal paris rouge signature parisien sunset likit mat ruj i choosu	0
COL name VAL loreal paris miss baby rolu siyah maskara	COL name VAL loreal paris miss baby rolu siyah maskara	1
COL name VAL loreal paris lorsal true match bakam yapan fondoten d golden amber	COL name VAL loreal paris eye lider merry metal superliler gold	0
COL name VAL loreal paris color riche la via en rose ruj esas pink	COL name VAL loreal paris color riche la via en rose ruj esas pink	1
COL name VAL loreal paris ruj infallible sexy bal never stop	COL name VAL loreal paris ruj infallible sexy bal never stop	1
COL name VAL lorsal paris true match bakam yapan fondoten n kanalla	COL name VAL lorsal paris true match bakam yapan fondoten lanen	0
COL name VAL loreal paris bronz bronzlaaytaraca pudra amali mediz	COL name VAL loreal paris true match bakam yapan fondoten belge	0
COL name VAL loreal paris bambi eye waterproof suya dayanakla ceylan gaz etkili maskara	COL name VAL loreal paris mat eye lider signature emeraude	0
COL name VAL lorsal paris blow mon ladies night neoncarnival dollar medium with warm olive likit aydanlataca no peachparty	COL name VAL lorsal paris superstar fiber siyah maskara	0
COL name VAL lorsal paris infaillible lip paint likit ruj lacquer fuschia wars	COL name VAL loreal paris ruj color riche free the nudes no dikkat	0
COL name VAL loreal paris gaz fara infallible eyeshadow paint opinionated	COL name VAL loreal paris emotions of nu allak ve far paleti gaz fara	0
COL name VAL loreal paris color queen goz far	COL name VAL loreal paris color queen goz far	1
COL name VAL loreal paris blow mon sangria pop belge cristallin coco likit aydanlataca try me on baby face	COL name VAL loreal paris lorsal maskara telescopic black	0
COL name VAL loreal paris lorsal infaillible h doganten wear dancer vitaminli fondoten black rose palmiye	COL name VAL loreal paris dudak kalemi infaillible lip bencil red fiction	0
COL name VAL loreal paris ruj sexy bal never stop	COL name VAL loreal paris ruj sexy bal never stop	1
COL name VAL loreal paris bambi oversized eye maskara siyah gaz kalemi	COL name VAL lorsal paris infaillible h gaz kalemi nude obsession	0
COL name VAL loreal paris ye il eye lider infallible style h irresistible kakisana	COL name VAL loreal paris ye il eye lider infallible style h irresistible kakisana	1
COL name VAL loreal paris rouge signature likit mat ruj	COL name VAL loreal paris likit mat ruj les macarons ultra liquid lipstick r infinite spice	0
COL name VAL loreal paris siyah eye lider ultra precisin superliler	COL name VAL loreal paris siyah eye lider ultra precisin superliler	1
COL name VAL loreal paris mat ruj color riche addiction lipstick pink ready to we	COL name VAL lorsal paris true match bakam yapan fondoten norc belge	0
COL name VAL loreal paris infaillible lip paint likit ruj mat king pink	COL name VAL loreal paris infaillible lip paint likit ruj mat king pink	1
COL name VAL lorsal paris true match bakam yapan fondoten d altin ve gumus bejnude	COL name VAL loreal paris careyse lipstick ruj	0
COL name VAL loreal paris likit mat ruj rouge signature rebel	COL name VAL loreal paris likit mat ruj rouge signature rebel	1
COL name VAL loreal paris brillant signature plump in glass renk i inflate	COL name VAL lorsal paris paradise kayasa kokulu turuncu maskara	0
COL name VAL loreal paris siyah maskara falso lash butterfly effect	COL name VAL loreal paris siyah maskara falso lash butterfly effect	1
COL name VAL loreal paris paradise suya dayanikli siyah maskara	COL name VAL loreal paris paradise suya dayanikli siyah maskara waterproof	1
COL name VAL loreal paris emberglow maskara million lashes true red for classic hair lapina yaz	COL name VAL loreal paris lorsal color riche free the nudes ruj no clicke	0
COL name VAL loreal paris infaillible h fresh wear golden belge fondoten sungeri seti	COL name VAL loreal paris infaillible h fresh wear golden belge fondoten sungeri seti	1
COL name VAL loreal paris lorsal infaillible h fondoten radiant belge	COL name VAL lorsal paris color riche mat addiction ruj voodoo mor	0
COL name VAL loreal paris infaillible metallik lip paint cete but psycho	COL name VAL loreal paris infaillible metallik lip paint cete but psycho	1
COL name VAL lorsal paris infaillible h ultra pouty prestige pudra out of control	COL name VAL loreal paris infaillible h ruj red karmasa	0
COL name VAL lorsal paris bronz please bronzlaaytaraca pudra taormina intenso	COL name VAL lorsal paris color queen tekli gaz fara flamingo	0
COL name VAL loreal paris n shell belge color riche plump and sine lipstick coral ezber seftali	COL name VAL lorsal paris le diner signature gaz kalemi gold velvet	0
COL name VAL loreal paris tekli goz fari color queen mono eyeshadow ferocious	COL name VAL loreal paris tekli goz fari color queen mono eyeshadow ferocious	1
COL name VAL loreal paris back to bronz color riche exclusive reis los burnu rose	COL name VAL loreal paris telescopic maskara	0
COL name VAL lorsal paris la via en blow aydanlataca paleti clarem red soayuk tonlar	COL name VAL lorsal paris infaillible h fondoten amber	0
COL name VAL loreal paris bambi oversized eye siyah maskara ayna	COL name VAL loreal paris bambi oversized eye siyah maskara ayna	1
COL name VAL lorsal paris brod constantcherry high contour gloxinia medium belge sedefli	COL name VAL loreal parsa miceller makyaj temizleme suyu normalden ve karmaya hassas ciltler hain ml	0
COL name VAL lorsal paris volumissime royale x siyah maskara	COL name VAL loreal paris lorsal true match bakam yapan fondoten golden chestnut	0
COL name VAL loreal paris brod artist pert no bony	COL name VAL loreal paris ka kalemi brod artist pert bony	1
COL name VAL loreal paris stick aydanlataca say in rose	COL name VAL lorsal paris infaillible gel arayon gaz kalemi back to black siyah	0
COL name VAL loreal paris les macarons likit mat ruj dose of rose	COL name VAL loreal paris likit mat ruj les macarons ultra liquid lipstick dose of ros	1
COL name VAL loreal paris renden voss pudra cobalt blue nocolor dcc dua power beni sap	COL name VAL loreal paris infaillible h fresh wear pudra fondoten rose sand	0
COL name VAL loreal paris miceller makyaj temizleme suyu normalden ve karmaya hassas ciltler iain ml	COL name VAL loreal paris tekli gaz fara color queen mono eyeshadow perceverance	0
COL name VAL lorsal paris extraordinaire rose melody	COL name VAL lorsal paris infaillible h fondoten sand	0
COL name VAL loreal paris color queen tekli gaz fara	COL name VAL loreal paris les chocolate ultra mat likit ruj oh my chou	0
COL name VAL loreal paris extraordinaire rouge soprano	COL name VAL loreal paris likit ruj color riche l extraordinaire lipstick rouge soprano	1
COL name VAL loreal paris color riche sine addiction ruj girlsnight	COL name VAL loreal paris ruj color riche sine addiction lipstick girls night	1
COL name VAL lorsal paris les chocolate likit mat ruj volupto chico	COL name VAL loreal paris color riche safari woman mat ruj balmain instinct	0
COL name VAL loreal paris pudra true match power w cinnamon	COL name VAL loreal paris pudra true match power w cinnamon	1
COL name VAL loreal paris waterproof arayon eye lider silver gold	COL name VAL loreal paris color riche sine addiction lipstick beauty queen ruj	0
COL name VAL lorsal paris color love bug tekli gaz fara super cooper	COL name VAL lorsal paris color riche sine ruj insanesation karmasa	0
COL name VAL loreal paris true match allik rose in love	COL name VAL loreal paris allik true match le blush no : rose in love	1
COL name VAL loreal paris kaya serumu brod asist pluto and acikuzum endless rose koyulila	COL name VAL loreal paris infaillible resurfacing gozenek gizleyici ve parazsazleaytirici makyaj baza	0
COL name VAL loreal paris brod artist paradise kas pomadi brunette kumral	COL name VAL loreal paris brod artist paradise kas pomadi brunette kumral	1
COL name VAL loreal paris true match bakim yapan fondoten r rose sand	COL name VAL loreal paris true match bakim yapan fondoten r rose sand	1
COL name VAL loreal paris gaz fara infaillible paint nude eyeshadow champagne	COL name VAL lorsal paris infaillible h fresh wear pudra fondoten cashmere	0
COL name VAL loreal paris ruj color riche free the nudes no prejudice	COL name VAL loreal paris ruj color riche free the nudes no prejudice	1
COL name VAL lorsal paris infaillible tam yaze uygulanabilir kapatacak vanilla	COL name VAL loreal paris infaillible h fresh wear pudra fondoten golden belge	0
COL name VAL loreal paris rouge signature likit mat ruj i enjoy	COL name VAL loreal paris rouge signature likit mat ruj i enjoy	1
COL name VAL lorsal paris true match bakam yapan fondoten r mauvelava natale mat canli kirmizi	COL name VAL lorsal paris infaillible tam yaze uygulanabilir kapatacak honey	0
COL name VAL loreal paris color riche sine addiction lipstick beauty queen ruj	COL name VAL lorsal paris color riche sine naked tane ruj topless nude	0
COL name VAL loreal paris true match bakam yapan fondoten n belge	COL name VAL lorsal paris true match bakam yapan fondoten ml ivory	0
COL name VAL lorsal paris les macarons likit metalik koyu haki nocolor eacbcca cool savage	COL name VAL loreal paris likit mat ruj infaillible lip paint lacquer gone with nude	0
COL name VAL lorsal paris true match bakam yapan fondoten r rose vanilla	COL name VAL loreal paris air volume saate kadar kalaca ekstra siyah maskara	0
COL name VAL lorsal paris back to peach pastel rustyorange bronzlaaytaraca pudra	COL name VAL loreal paris lorsal infaillible h fresh wear c vitaminli fondoten golden vanilla	0
COL name VAL loreal paris la petite far paleti maximalist	COL name VAL loreal paris goz fari paleti la petite palette maximalist	1
COL name VAL loreal paris makyaj fircasiallik fircasi	COL name VAL loreal paris makyaj allik fircasi	1
COL name VAL loreal paris goz fari	COL name VAL loreal paris goz fari	1
COL name VAL loreal paris bronz to paradise mat bronzlastirici pudra baby one more tan	COL name VAL loreal paris bronz to paradise mat bronzlastirici pudra baby one more tan	1
COL name VAL loreal paris fondoten infallible jole de blitz venice	COL name VAL loreal paris superliler smokinsime black smoke	0
COL name VAL loreal paris dirty mind eye lider warmsilver junglegreen signature no zeytin	COL name VAL loreal paris tekli gaz fara color queen mono eyeshadow extra	0
COL name VAL loreal paris brod artist plump set renkli ka sabitleyici maskara dark brunette	COL name VAL loreal paris kas serumu brod asist pluto set dark brunette	1
COL name VAL loreal paris lash jl milk pinky beles oui ekstran light with neutral belge maskara	COL name VAL loreal paris true match bakam yapan fondoten d golden ivory	0
COL name VAL loreal paris true match bakam yapan fondoten r nut brown	COL name VAL lorsal paris cast magic bb krem medium light	0
COL name VAL loreal paris aydanlataca palet en blow warm farka seti	COL name VAL loreal paris kapatacak true match concealer g vanilla	0
COL name VAL loreal paris rouge signature empowereds likit mat ruj prepared	COL name VAL loreal paris rouge signature empowereds likit mat ruj prepared	1
COL name VAL lorsal paris infaillible h fondoten cok acik krem	COL name VAL lorsal paris air mega volume maskara saate kadar kalaca ekstra siyah	0
COL name VAL loreal paris paradise siyah maskara	COL name VAL lorsal paris infaillible mat max ruj say my name	0
COL name VAL loreal paris lorsal nocolor db barbie pink maskara	COL name VAL loreal paris infaillible resurfacing gozenek gizleyici ve parazsazleaytirici baz	0
COL name VAL loreal paris can ivory floresan orani color riche nocolor ace addiction lipstick moka brownenim qd haki green	COL name VAL loreal paris kaya kalemi brod artist high contour warm brown	0
COL name VAL loreal paris allak ve bronzlaaytaraca pudra blush cherie on the cake bronzer dark chocolate	COL name VAL lorsal paris rouge signature empowereds likit mat ruj armored	0
COL name VAL loreal paris telescopic maskara	COL name VAL loreal paris infaillible h mat cover yaksek kapatacak fondoten rose porcelain	0
COL name VAL loreal paris color riche x balmain ruj confidence nude	COL name VAL loreal paris uzun sare kalaca fondoten infallible h foundation n golden ml	0
COL name VAL loreal paris merry metal superliler gold eye lider	COL name VAL loreal paris lorsal true match bakam yapan fondoten ivory	0
COL name VAL loreal paris shimmer color riche privye bright crimson doutzene saripembe	COL name VAL lorsal paris paradise suya dayanakla siyah maskara	0
COL name VAL loreal paris kadar no color ruj	COL name VAL lorsal paris infaillible shaping stick fondoten karamel	0
COL name VAL loreal paris color riche sine ruj insanesation kirmizi	COL name VAL loreal paris color riche sine addiction lipstick ruj	1
COL name VAL loreal paris color riche lekhol gaz kalemi pure espresso	COL name VAL loreal paris likit ruj color riche lextraordinaire lipstick fuchsa drama	0
COL name VAL loreal paris true match kapatici d / w golden amber	COL name VAL loreal paris true match kapatici d / w golden amber	1
COL name VAL loreal paris rouge signature empowereds likit mat ruj honored	COL name VAL loreal paris rouge signature empowereds likit mat ruj honored	1
COL name VAL lorsal paris infallible stay ultraviolet dudak kalemi	COL name VAL lorsal paris infaillible h fondoten d amber	0
COL name VAL loreal paris lorsal infaillible h pyrenees metalik fume wear metalikbronz vitaminli fondoten neutral blonde redextreme	COL name VAL lorsal paris color riche collection privye juliannem nude ruj	0
COL name VAL loreal paris ceylan gaz etkili ekstra siyah maskaramaybelline kanal kalemi	COL name VAL loreal paris les macarons ultra mat likit ruj d strawberry	0
COL name VAL loreal paris rouge signature likit mat ruj enjoy	COL name VAL loreal paris kaya maskarasi brod asist pluto and set brunette	0
COL name VAL loreal paris color riche mat addiction ruj cherry bordo	COL name VAL loreal paris color riche mat addiction ruj cherry bordo	1
COL name VAL loreal paris emotions of sculpt allak andamp far paleti	COL name VAL loreal paris falso lash telescopic fiber siyah maskara	0
COL name VAL lorsal paris rouge signature likit mat ruj i achieve	COL name VAL loreal paris tekli gaz fara color queen mono eyeshadow determination	0
COL name VAL loreal paris kas maskarasi brod asist pluto set bony	COL name VAL loreal paris kas maskarasi brod asist pluto set bony	1
COL name VAL loreal paris likit mat ruj les chocolate ultra liquid lipstick oh my chow	COL name VAL loreal paris ruj color riche sine addiction lipstick lead girls night	0
COL name VAL loreal infaillable lipstick step toujours t	COL name VAL loreal paris ruj color riche free the nudes rc no prejudice	0
COL name VAL loreal paris lorsal true match nude fondoten serum light	COL name VAL lorsal paris color queen tekli gaz fara r force	0
COL name VAL loreal paris color riche mat addiction ruj bronz sautoir kahverengi	COL name VAL loreal paris color riche mat addiction ruj bronz sautoir kahverengi	1
COL name VAL loreal paris les macarons ultra gri kircil hologram likit jl icy pink framboise	COL name VAL loreal paris true match bakam yapan fondoten n belge	0
COL name VAL loreal paris infaillible h mat fondoten belge evlat	COL name VAL loreal paris stick allak infaillible shaping sexy flash	0
COL name VAL loreal paris kadin pembe likit aydinlatici blow mon amour droplet high light melon dollar baby	COL name VAL loreal paris kadin pembe likit aydinlatici blow mon amour droplet high light melon dollar baby	1
COL name VAL lorsal paris brod nfirecracker high contour shinyplum chocolate ambargo	COL name VAL loreal paris saat kalaca kalem no	0
COL name VAL loreal paris nocolor deb signature deep nude likit deeptin dont	COL name VAL loreal paris siyah eye lider smokinsime superliler black	0
COL name VAL loreal paris likit mat ruj rouge signature	COL name VAL loreal paris likit mat ruj rouge signature	1
COL name VAL loreal paris goz fari paleti la palette nude belge	COL name VAL loreal paris goz fari paleti la palette nude belge	1
COL name VAL loreal paris stick fondoten infaillible shaping sand	COL name VAL loreal paris stick fondoten infaillible shaping sand	1
COL name VAL lorsal paris infaillible dudak kalemi gone with the nude	COL name VAL loreal paris tekli gaz fara color queen mono eyeshadow persistence	0
COL name VAL loreal paris color queen tekli goz fari ruthless	COL name VAL loreal paris color queen tekli goz fari ruthless	1
COL name VAL loreal paris volumissime x carbon black maskara siyah	COL name VAL loreal paris volumissime voluminous x extra black volume maskara	1
COL name VAL loreal paris rouge signature likit mat ruj rule	COL name VAL loreal paris infaillible h fresh wear belge dorekajal gaz kalemi	0
COL name VAL loreal paris infaillible h mat fondoten mil honey	COL name VAL loreal paris infaillible h mat fondoten mil honey	1
COL name VAL loreal paris unbelieva brod uzun sure kalici kas jeli bony	COL name VAL loreal paris unbelieva brod uzun sure kalici kas jeli bony	1
COL name VAL loreal paris goz fari infallible eyeshadow paint infinite blue	COL name VAL loreal paris goz fari infallible eyeshadow paint infinite blue	1
COL name VAL lorsal paris infaillible h seffafsimla wear pudra fondoten forest	COL name VAL loreal paris true match bakam yapan fondoten r rose	0
COL name VAL loreal paris infaillible sculpt palette kontur paleti light medium	COL name VAL loreal paris kontur paleti infallible sculpt contouring palette light	1
COL name VAL loreal paris lorsal infaillible h light with warm olive wear everyday pretty vitaminli fondoten pink shell rose tabii	COL name VAL lorsal paris color queen tekli gaz fara ruthless	0
COL name VAL loreal paris unlimited siyah maskara garnier miceller temsuyu	COL name VAL loreal paris tekli gaz fara color queen mono eyeshadow commander	0
COL name VAL lorsal paris cherie on the cake allak ve bronzlaaytaraca pudra whitepearl arrow mint yesili	COL name VAL loreal paris hacim veren siyah maskara volumissime royale x	0
COL name VAL loreal paris lorsal infaillible h fresh wear c vitaminli fondoten rose belge	COL name VAL loreal paris color riche intense volume mat ruj blush audice	0
COL name VAL lorsal paris true match bakam yapan fondoten lanen	COL name VAL lorsal paris true match bakam yapan fondoten n golden amber	0
COL name VAL loreal paris suya dayanakla siyah eye lider super black lacquer waterproof ml	COL name VAL lorsal paris infaillible h fondoten natural rose	0
COL name VAL lorsal paris infaillible h concealer pomada kapatacak gs pinkrockcandy ton	COL name VAL loreal paris ruj color riche free the nudes no obstacles	0
COL name VAL lorsal paris telescopic maskara siyah paket	COL name VAL loreal paris infaillible h fresh wear pudra fondoten cashmere	0
COL name VAL lorsal paris gram bronz dua pudra	COL name VAL loreal paris ruj color riche lipstick oud obsession	0
COL name VAL lorsal paris color riche addictive coral camelliahill mon jules	COL name VAL lorsal paris true match bakam yapan fondoten n creama belge	0
COL name VAL loreal paris true match nude serum fondoten very light	COL name VAL loreal paris kaya kalemi brod artist pert cool bruce	0
COL name VAL loreal paris lorsal true match bakam yapan fondoten tanorse	COL name VAL loreal paris true match bakam yapan fondoten n belge	0
COL name VAL loreal paris falso lash telescopic fiber maskara ml	COL name VAL loreal paris ruj lip paint metallik lolita	0
COL name VAL loreal paris color riche turkish delight addiction siyah kalin cizgi pembekahverengi clutch	COL name VAL lorsal paris brod artist shapen kaya kalemi brunette	0
COL name VAL loreal paris infaillible h fresh wear c vitaminli fondoten rose belge	COL name VAL loreal paris infaillible h fresh wear c vitaminli fondoten rose belge	1
COL name VAL loreal paris ruj lip paint metallik lolita	COL name VAL lorsal paris color riche mat addiction ruj moka chic nude	0
COL name VAL loreal paris hitchi coral lip paint olum pie lolita	COL name VAL loreal paris eye lider smokinsime superliler tupe smoke	0
COL name VAL loreal paris lorsal infaillible h tam yaze uygulanabilir kapatacak vecan	COL name VAL lorsal paris true match kapatacak belge	0
COL name VAL loreal paris kusursuz makyaj temizleme suyu hassas ml	COL name VAL loreal paris miceller kusursuz makyaj temizleme suyu hassas ml	1
COL name VAL loreal paris true match bakam yapan fondoten hangouts	COL name VAL lorsal paris bambi eye ceylan gaz etkili maskara siyah ml	0
COL name VAL lorsal paris infaillible h mat fondoten belge dore	COL name VAL lorsal paris les macarons likit mat ruj framboise frenzy	0
COL name VAL loreal paris lorsal blow mon creamybeige likit aydanlataca living kirsch peach	COL name VAL lorsal paris infaillible h fondoten amber	0
COL name VAL lorsal paris les chocolate likit gokyuzu mavisi justdeluxe nocolot of chocolatem	COL name VAL loreal paris infaillible h mat cover yaksek kapatacak fondoten golden belge	0
COL name VAL loreal paris ceylan gaz etkili ekstra maskara siyah mabelline newyork kanal kalemi	COL name VAL loreal paris lorsal brillant signature plump in glass ruj ml i sor	0
COL name VAL loreal paris les macarons likit mat ruj dose of rose	COL name VAL loreal paris les macarons likit mat ruj dose of rose	1
COL name VAL loreal paris accord parfait pire fr d / wc	COL name VAL loreal paris accord parfait pire fr d / wc	1
COL name VAL loreal paris bambi oversized eye siyah maskara li set	COL name VAL loreal paris color rica ultra mat ruj no d hesitation	0
COL name VAL loreal paris infaillible h fondoten vanilla	COL name VAL loreal paris infaillible h fondoten vanilla	1
COL name VAL lorsal paris miceller kusursuz makyaj temizleme suyu normal ml	COL name VAL loreal paris siyah maskara lash superstar black ml	0
COL name VAL loreal paris sweetcoral color riche sine addiction lipstick hot irl	COL name VAL lorsal paris la via en blow aydanlataca paleti cool soayuk tonlar	0
COL name VAL loreal paris likit no mor kar beyaz color riche lextraordinaire lipstick mercanrengi yavruagazi opera	COL name VAL loreal paris infaillible h mat cover yaksek kapatacak fondoten golden belge	0
COL name VAL loreal paris infaillible h l ngoldrush cover yaksek kapatacak fondoten the best blonde	COL name VAL lorsal paris superliler smokinsime eye lider black	0
COL name VAL loreal paris colorsta effects balayage	COL name VAL loreal paris infaillible lip paint likit ruj mat wuthering purple	1
COL name VAL loreal paris ruj color riche sine addiction lipstick hot irl	COL name VAL loreal paris color riche sine ruj hot irl kahverengi	1
COL name VAL lorsal paris mega volume miss manga maskara	COL name VAL lorsal paris infaillible h mat cover yaksek kapatacak fondoten golden sand	0
COL name VAL loreal paris tekli gaz fara color abd warm honey mono eyeshadow turuncu mavi yesil	COL name VAL loreal paris koyu siyah maskara lash architects d midnight black	0
COL name VAL lorsal paris unlimited dollpink maskara	COL name VAL loreal paris color riche les nus ruj nu decadent	0
COL name VAL loreal paris bb krem acik ton skin perfectin cream light spf ml	COL name VAL loreal paris skin perfectin cilt kusursuzlastirici i arada bb krem acik ton	1
COL name VAL loreal paris kaya kalemi brod designe red pert n honey bruce	COL name VAL lorsal paris true match nude fondoten serum very light	0
COL name VAL loreal paris true match bakam yapan fondoten d double shot girlfriend	COL name VAL loreal paris les macarons ultra mat likit ruj blackcurrant	0
COL name VAL loreal paris brod artist micro tattoo cool brunette koyu kumral	COL name VAL loreal paris ka kalemi brod artist micro tattoo cool brunette	1
COL name VAL loreal paris infaillible dudak kalemi stripped brown kahverengi	COL name VAL loreal paris infaillible dudak kalemi stripped brown kahverengi	1
COL name VAL loreal paris infaillible h mid blue wear pudra fondoten cadiz	COL name VAL lorsal paris infaillible dudak kalemi red fiction karmasa	0
COL name VAL loreal paris color riche free the nudes ruj no judgment	COL name VAL loreal paris color riche free the nudes ruj no judgment	1
COL name VAL loreal paris siyah bambi eye oversized ceylan gaz etkili maskara	COL name VAL lorsal paris true match nude fondoten serum very light	0
COL name VAL loreal paris aytasi color riche free the invisible brod moss dikkat	COL name VAL loreal paris likit ruj gram sine hours	0
COL name VAL lorsal paris infaillible lip paint likit ace nocolor fbci king m steel grey	COL name VAL lorsal paris infaillible dudak kalemi red fiction karmasa	0
COL name VAL lorsal paris infaillible h mat cover yaksek kapatacak fondoten golden sun	COL name VAL loreal paris lorsal infaillible tam yaze uygulanabilir kapatacak vanilla	0
COL name VAL lorsal paris holy red canli turuncu kirmizi signature empowereds likit morning dance nsparkleon discovere	COL name VAL lorsal paris infallible waterproof gel arayon eye lider golden woman	0
COL name VAL loreal paris infaillible h mat cover yuksek kapatici fondoten golden sun	COL name VAL loreal paris infaillible h mat cover yuksek kapatici fondoten golden sun	1
COL name VAL loreal paris brod artist high contour cool brunette koyu kumral	COL name VAL loreal paris ka kalemi brod artist high contour cool brown	1
COL name VAL loreal paris les chocolate ultra jl barbie likit pearli champagne rich purple	COL name VAL loreal paris true match bakam yapan fondoten r rose belge	0
COL name VAL loreal paris infaillable automatic jel goz kalemi mavi	COL name VAL loreal paris infaillable automatic jel goz kalemi mavi	1
COL name VAL loreal paris yorgunluk izleri karsiti cc krem nude magique ml	COL name VAL loreal paris yorgunluk izleri karsiti cc krem nude magique ml	1
COL name VAL loreal paris colorsta effects balayage	COL name VAL loreal paris colorsta effects balayage	1
COL name VAL loreal paris color riche collection exclusive doutzen s pure red	COL name VAL loreal paris color riche collection exclusive doutzen s pure red	1
COL name VAL loreal paris true match bakim yapan fondoten r rose vanilla kapatici n	COL name VAL loreal paris true match bakim yapan fondoten r rose vanilla kapatici n	1
COL name VAL loreal paris hdf signature likit sweet sakura kisse bronz i represent	COL name VAL loreal paris lorsal true match nude fondoten serum light medium	0
COL name VAL loreal paris air volume mega hacim veren maskara siyah	COL name VAL loreal paris color rica ultra mat ruj no hesitation	0
COL name VAL loreal paris kaya serumu brod asist pluto and let me down cali deep yaz	COL name VAL loreal paris eye lider superliler smokinsime brown smoke	0
COL name VAL loreal paris mega volume collagene h siyah maskara	COL name VAL loreal paris true match bakam yapan fondoten ivory	0
COL name VAL loreal paris likit metalik pembe autumn sparkla yan signature i explorer	COL name VAL loreal expert paris infaillible h fondoten belge rose	0
COL name VAL lorsal paris color riche nocolor babdbf addiction eternalflame mediumdark grilila	COL name VAL loreal para mat ruj color rachel addactaon storm	0
COL name VAL loreal paris saat kalici ruj infallible rouge lawless fuschia	COL name VAL loreal paris infaillible h ruj lawless fuschia	1
COL name VAL lorsal paris superliler superstar siyah eye lider	COL name VAL loreal paris visible lift serum inside mat dw	0
COL name VAL loreal paris miceller	COL name VAL loreal paris miceller makyaj temizleme suyu normalden ve karmaya hassas ciltler icin ml	1
COL name VAL lorsal paris butterbronzer suya dayanakla desenli mavi maskara	COL name VAL loreal paris likit mat ruj les macarons ultra liquid lipstick blackcurrant crush	0
COL name VAL loreal paris mega volume collagene h siyah maskara	COL name VAL lorsal paris les macarons likit mat ruj blackcurrant crush	0
COL name VAL loreal paris siyah maskara volume million lashes feline black	COL name VAL loreal paris siyah maskara volume million lashes feline black	1
COL name VAL loreal paris infaillible h fondoten belge dore	COL name VAL loreal paris fondoten infallible golden bej	1
COL name VAL loreal paris true match bakam yapan fondoten n ivory	COL name VAL loreal paris kahverengi eye lider infallible style ml n chocolate addict	0
COL name VAL loreal paris ruj lip paint mat red actually	COL name VAL loreal paris ruj lip paint mat red actually	1
COL name VAL loreal paris color riche sine naked tane ruj belge in the city nude	COL name VAL loreal paris color riche sine naked tane ruj belge in the city nude	1
COL name VAL loreal paris telescopic carbon black maskara siyah and infaillible h fresh wear pudra fondoten vanilla	COL name VAL lorsal paris true match allak rose pastel	0
COL name VAL lorsal paris infaillible h gaz kalemi chocolate addiction	COL name VAL loreal paris dudak kalemi infaillible lip bencil stay ultraviolet	0
COL name VAL loreal paris pink sand color riche free the teknon nocolor fad hesitation	COL name VAL loreal paris cr ultra mat ruj no obstacle	0
COL name VAL loreal paris smokey lip arayon super star max batik desenli pembe gray brown	COL name VAL loreal paris siyah eye lider infaillible gel arayon black	0
COL name VAL loreal paris lorsal hacim veren maskara siyah	COL name VAL loreal paris likit mat ruj les chocolate ultra liquid lipstick sweet toth	0
COL name VAL loreal paris color riche lipstick violet saturn	COL name VAL loreal paris siyah eye lider smokinsime superliler black	0
COL name VAL lorsal paris true match silver sensation fondoten serum individualist kirmizi	COL name VAL loreal paris kadar orange magique ruj	0
COL name VAL lorsal paris unlimited siyah maskara	COL name VAL lorsal paris infaillible h mat cover yaksek kapatacak fondoten rose belge	0
COL name VAL lorsal paris infaillible h saat cover yaksek kapatacak fondoten altin serit matriochkared	COL name VAL lorsal paris color queen tekli gaz fara	0
COL name VAL lorsal paris rouge signature parisien sunset likit mat ruj i amade	COL name VAL lorsal paris infaillible eye paint gaz fara eternal white	0
COL name VAL loreal paris miceller makyaj temizleyici paradise intense maskara seti	COL name VAL loreal paris true match bakam yapan fondoten ivory	0
COL name VAL lorsal paris passion red signature lip hopper dudak parlatacak nocolor abaff nudee wmediumdeep	COL name VAL lorsal paris true match bakam yapan fondoten n sand	0
COL name VAL loreal paris infallible automatic eye lider yo un siyah	COL name VAL loreal paris infaillable automatic jel goz kalemi yogun siyah	1
COL name VAL lorsal paris extraordinaire p fushia soprano	COL name VAL loreal paris stick allak infaillible shaping nude in rose	0
COL name VAL lorsal paris true match bakam yapan fondoten n porcelaan	COL name VAL lorsal paris infallible waterproof gel arayon eye lider n golden woman	0
COL name VAL loreal paris brod artist skinny define kas kalemi dark brunette	COL name VAL loreal paris brod artist skinny define ka kalemi dark brunette	1
COL name VAL loreal paris likit mat ruj rouge signature i achieve	COL name VAL loreal paris rouge signature likit mat ruj i achieve	1
COL name VAL loreal paris shore pudra infaillible h ultra hotspice prestige dainty don t	COL name VAL lorsal paris color riche free the nudes ruj no dikkat	0
COL name VAL loreal paris likit mat ruj rouge signature	COL name VAL lorsal paris lash arch black lacqu maskara	0
COL name VAL lorsal paris unlimited multicolor maskara	COL name VAL lorsal paris paradise suya dayanakla siyah maskara	0
COL name VAL lorsal paris infaillible metallik eye paint copper	COL name VAL loreal paris careyse lipstick ruj	0
COL name VAL loreal paris color riche unsurpassed volume winered chili acik determination	COL name VAL loreal paris telescopic maskara	0
COL name VAL loreal paris likit metalik ruj rouge signature metallik i voodoo	COL name VAL loreal paris likit metalik ruj rouge signature metallik i voodoo	1
COL name VAL lorsal paris les macarons likit nocolor cbb n light with neutral belge neon fuchsla sedefli beyaz hologram	COL name VAL loreal paris kapatacak true match concealer rc rose belge	0
COL name VAL loreal paris infaillible gozenek gizleyici beyazdansiyaha baza	COL name VAL loreal paris allak skin awakening blush back to bronz	0
COL name VAL loreal paris infaillible resurfacing gozenek gizleyici ve parazsazleaytirici just wonderini	COL name VAL lorsal paris mega glass lip revolution fabulous	0
COL name VAL loreal paris infaillible dudak kalemi apocalypse red kirmizi	COL name VAL loreal paris dudak kalemi infaillible lip bencil apocalypse red	1
COL name VAL loreal paris infallible sale sand fondoten	COL name VAL loreal paris infallible sale sand fondoten	1
COL name VAL loreal paris color riche les nus ruj decadent	COL name VAL loreal paris likit mat ruj infallible lip paint ml tanzerine vertigo	0
COL name VAL lorsal paris true match bakam yapan fondoten r rose ivory	COL name VAL loreal paris brod artist skinny define kaya kalemi chastain	0
COL name VAL loreal paris lorsal blow mon cherry wild child likit aydanlataca living raspberry cream	COL name VAL loreal paris miceller makyaj temizleme suyu normalden ve karmaya hassas ciltler iain	0
COL name VAL loreal paris les macarons ultra mat likit ruj blackcurrant	COL name VAL loreal paris les macarons likit mat ruj blackcurrant crush	1
COL name VAL lorsal paris brod artist pert no warm brunette	COL name VAL lorsal paris infaillible h mat cover yaksek kapatacak fondoten amber	0
COL name VAL loreal paris true match bakam yapan fondoten d gokyuzumavisi gul pembe	COL name VAL lorsal paris rouge signature likit mat ruj i stand	0
COL name VAL loreal paris tekli gaz fara color queen mono eyeshadow unsurpassed	COL name VAL lorsal paris infaillible h gaz kalemi g lawless grey	0
COL name VAL loreal paris infaillible h fresh wear c vitaminli fondoten rose ivory	COL name VAL lorsal paris les macarons likit mat ruj dose of rose	0
COL name VAL loreal paris mat ruj color riche addiction stone	COL name VAL loreal paris kaya kalemi brod artist high contour cool brown	0
COL name VAL lorsal paris decisine poppy signature parisien femme natale likit nocolor eebf dry merlot i led	COL name VAL lorsal paris superliler smokinsime eye lider black	0
COL name VAL loreal paris color richplum addiction can spice d warm nude	COL name VAL loreal paris ruj labial color riche careyse lipstick cheeky macenta	0
COL name VAL loreal paris siyah maskara falso lash architects d black	COL name VAL loreal paris stick fondoten infaillible longwear shaping foundation karamel w g	0
COL name VAL lorsal paris bambi eye ceylan gaz etkili maskara siyah ml	COL name VAL lorsal paris true match prestige pudra golden belge	0
COL name VAL loreal paris likit mat ruj rouge signature savar	COL name VAL lorsal paris rouge careyse n impulsive fuchsla ruj	0
COL name VAL loreal paris rouge careyse rocknmauve ruj	COL name VAL loreal paris ruj labial color riche careyse lipstick rock maude	1
COL name VAL lorsal paris color riche free the amethyste macao whatin carnation doubt	COL name VAL loreal paris lorsal true match bakam yapan fondoten d golden amber	0
COL name VAL loreal paris saat kalaca brightenerhoney infaillible sparklingshake granit vamp	COL name VAL lorsal paris rouge signature empowereds likit mat ruj desiren	0
COL name VAL loreal paris ruj color riche lipstick mon jules	COL name VAL lorsal paris anfaillible eye lider stay blue	0
COL name VAL loreal paris infaillible h roseatepink wear pudra fondoten coffeebrown nocolor defce	COL name VAL lorsal paris true match fondoten c amber rose	0
COL name VAL loreal paris tekli goz fari color queen mono eyeshadow gilden	COL name VAL loreal paris tekli goz fari color queen mono eyeshadow gilden	1
COL name VAL loreal paris infaillible sexy bal ruj go pretty or home	COL name VAL loreal paris infaillible sexy bal ruj go pretty or home	1
COL name VAL lorsal paris infaillible lip paint likit ruj lacquer pink lady pembe	COL name VAL lorsal paris true match bakam yapan fondoten rc rose belge	0
COL name VAL loreal paris emotions of nu allik ve far paleti goz fari	COL name VAL loreal paris emotions of nu allik ve far paleti goz fari	1
COL name VAL loreal paris lorsal infaillible h sun stone wear watch out vitaminli fondoten y golden medium nocolor cff	COL name VAL lorsal paris bambi oversized eye maskara siyah	0
COL name VAL loreal paris infallible longwear lip lider apocalypse red	COL name VAL loreal paris ral infmacaronsnu ruj dw infinity sp	0
COL name VAL loreal paris chicstiletto eye lider morninglight signature red square	COL name VAL lorsal paris color riche plump and sine ruj guava	0
COL name VAL lorsal paris infallible waterproof gel arayon eye lider navy life	COL name VAL loreal paris brillant signature plump in glass ruj d i leighten	0
COL name VAL loreal paris color riche sine ruj map to nirvana mor	COL name VAL loreal paris color riche sine addiction lipstick map to nirvana ruj	1
COL name VAL loreal paris true match pudra	COL name VAL loreal paris true match pudra	1
COL name VAL loreal paris stick aydinlatici infaillible shaping gold is cold	COL name VAL loreal paris infaillible shaping stick aydinlatici gold is cold	1
COL name VAL loreal paris les macarons ultra baadere likit mat cream blackcurrant	COL name VAL loreal paris perfect slim by superliler siyah eye lider	0
COL name VAL lorsal paris sharp amber concentrate signature likit lavanta pl pink pearl i dont	COL name VAL loreal paris lorsal color riche saten bitiayli ruj pink pigalle pembe	0
COL name VAL loreal paris infaillible h mat cover yaksek kapatacak fondoten no amber	COL name VAL loreal paris les macarons ultra mat likit ruj blackcurrant	0
COL name VAL loreal paris pudra true match power d w golden ivory	COL name VAL loreal paris true match pudra w golden ivory	1
COL name VAL lorsal paris tinkle riche extraordinaire softkiss maude it finale	COL name VAL loreal paris true match kapatacak n creama belge	0
COL name VAL loreal paris miceller kusursuz makyaj temizleme suyu normal ml	COL name VAL loreal paris miceller kusursuz makyaj temizleme suyu normal ml	1
COL name VAL lorsal paris turuncu siyah sine calmy glass	COL name VAL lorsal paris color riche sine ruj mlbb nude	0
COL name VAL lorsal paris brillant signature plump in glass nhype i inflate	COL name VAL lorsal paris skin perfectin cilt kusursuzlaaytaraca i arada bb krem orta ton	0
COL name VAL loreal paris pudra true match power w cinnamon	COL name VAL loreal paris true match power w cinnamon	1
COL name VAL lorsal paris infaillible h mat cover yaksek kapatacak fondoten golden amber	COL name VAL loreal paris les chocolate ultra mat liquid lipstick yumsana	0
COL name VAL loreal paris bambi eye ceylan gaz etkili maskara siyah x	COL name VAL loreal paris kapatacak and aydanlataca ayak lumimagic highlighter pen light	0
COL name VAL loreal paris infaillible eye paint goz fari irresistible rose	COL name VAL loreal paris infaillible eye paint goz fari irresistible	1
COL name VAL loreal paris blow mon stringer droplet high light nocolor fefdf in a little tropikal likit aydanlataca	COL name VAL loreal paris true match bakam yapan fondoten n belge	0
COL name VAL loreal paris dark deep toprak yesil bonjour nudista big date ultimate fc nroseihold dahli	COL name VAL loreal paris true match bakam yapan fondoten n sand	0
COL name VAL loreal paris color riche intense volume mat ruj nude admirable	COL name VAL loreal paris infaillible mat lip arayon kalem ruj maple dream	0
COL name VAL loreal paris cast magic intense brown light porcelain fc squashed raspberry	COL name VAL lorsal paris true match bakam yapan fondoten d golden almond	0
COL name VAL loreal paris kazaraklak giderici princess belike baza infaillible anti rich copper eros	COL name VAL loreal paris waterproof arayon eye lider silver	0
COL name VAL lorsal paris color riche plump and sine kirmizisaraprengi spk electric ruby	COL name VAL loreal paris brod artist plumpandset renkli kaya sabitleyici maskara dark brunette	0
COL name VAL loreal paris haghlaghter blow mon amour low de coco	COL name VAL lorsal paris color riche sine ruj mlbb nude	0
COL name VAL lorsal paris infaillible h gaz kalemi nude obsession	COL name VAL lorsal paris color riche mat addiction ruj n amulet yayil	0
COL name VAL loreal paris volumissime x carbon black maskara siyah	COL name VAL loreal paris volumissime x carbon black maskara siyah	1
COL name VAL loreal paris true match bakam yapan fondoten r rose vanilla	COL name VAL loreal paris le diner signature gaz kalemi ml tupe grey tween	0
COL name VAL loreal paris mavi infaillible gel arayon eye lider blue	COL name VAL loreal paris color riche lipstick	0
COL name VAL lorsal paris rouge signature likit mat ruj i represent	COL name VAL lorsal paris infaillible h concealer pomada kapatacak peach nar	0
COL name VAL lorsal paris electrique pink schiap dua pudra	COL name VAL loreal paris rouge signature mat likit ruj achaeve	0
COL name VAL loreal paris satin rouge lip paint bordo koyu lolita	COL name VAL loreal paris likit mat ruj les chocolate ultra liquid lipstick box of chocolatem	0
COL name VAL lorsal paris infaillible h mat cover yaksek kapatacak fondoten rose belge	COL name VAL lorsal paris infaillible metallik lip paint n dixie	0
COL name VAL loreal paris tekli gaz fara color morning star mono eyeshadow charger	COL name VAL loreal paris true match bakam yapan fondoten r rose ivory	0
COL name VAL loreal paris infallible waterproof gel arayon eye lider christmas day	COL name VAL loreal paris waterproof arayon eye lider christmas	1
COL name VAL lorsal paris superstar fiber extreme resit suya dayanakla siyah maskara	COL name VAL loreal paris infaillable lipstick step d toujours	0
COL name VAL loreal paris rouge signature metallik likit ruj i voodoo	COL name VAL loreal paris rouge signature metallik likit ruj i voodoo	1
COL name VAL loreal paris color riche x balmain collection rock woman mat ruj legend	COL name VAL loreal paris color riche x balmain collection rock woman mat ruj legend	1
COL name VAL lorsal paris brod artist high contour brunette kumral	COL name VAL loreal paris fondoten true match foundation golden belge ml	0
COL name VAL loreal paris infaillible tam yaze uygulanabilir kapatacak sweetandsour	COL name VAL loreal paris true match bakam yapan fondoten d golden ivory	0
COL name VAL loreal paris jel kaya pomada brod artist no brunette	COL name VAL lorsal paris blow mon amour melon dollar baby likit aydanlataca no ml	0
COL name VAL lorsal paris color riche sine brillantlatte peach smoothie karmasa	COL name VAL lorsal paris infaillible tam yaze uygulanabilir kapatacak ivory	0
COL name VAL loreal paris tekli goz fari color queen mono eyeshadow ruthless	COL name VAL loreal paris color queen tekli goz fari ruthless	1
COL name VAL loreal paris paradise maskara	COL name VAL loreal paris likit mat ruj les macarons ultra liquid lipstick ml dose of ros	0
COL name VAL loreal paris likit mat ruj les chocolate ultra liquid lipstick box of chocolatem	COL name VAL loreal paris bej eye lider infaillible gel arayon belge	0
COL name VAL lorsal paris mat signature eye lider burgundy bordo	COL name VAL loreal paris mat lip arayon no brulse everday kalem ruj	0
COL name VAL lorsal paris color riche sine ruj beauty queen mor	COL name VAL lorsal paris true match bakam yapan fondoten golden ivory	0
COL name VAL loreal paris anti age serumlu ruj s	COL name VAL loreal paris color riche serum ruj renk : s true red	1
COL name VAL loreal paris lorsal le diner signature waterroof gri gaz kalemi tupe grey tween	COL name VAL loreal paris pudra true match power rose belge	0
COL name VAL loreal paris brillant red color riche lipstick oud obsession	COL name VAL lorsal paris true match allak rose in love	0
COL name VAL loreal paris true match bakam yapan fondoten n belge	COL name VAL lorsal paris bonjour nudista aydanlar veren renkli nemlendirici medium dark koyu ton	0
COL name VAL lorsal paris mas color riche lipstick burning popular nude	COL name VAL loreal paris lorsal true match bakam yapan fondoten d golden sand	0
COL name VAL loreal paris volume mallan lashes bal noir	COL name VAL lorsal paris infaillible h fondoten radiant belge	0
COL name VAL loreal paris aydanlataca lavishonyx en blow sangria pop farka seti	COL name VAL lorsal paris mega volume collagene h siyah maskara	0
COL name VAL lorsal paris brod artist shapen kaya kalemi blonde	COL name VAL loreal paris true match foundation golden almond fondoten	0
COL name VAL loreal paris rouge signature likit mat ruj i done	COL name VAL loreal paris rouge signature mat likit ruj dont	1
COL name VAL loreal paris infaillible resurfacing gozenek gizleyici ve puruzsuzlestirici baz	COL name VAL loreal paris makyaj bazi infaillible mattfying	1
COL name VAL loreal paris anti age serumlu ruj s	COL name VAL loreal paris anti age serumlu ruj s	1
COL name VAL loreal paris ruj color riche privye nudes frida cp	COL name VAL loreal paris ruj color riche privye nudes frida cp	1
COL name VAL loreal paris true match fondoten n vanilla	COL name VAL lorsal paris rouge signature empowereds likit mat ruj desiren	0
COL name VAL loreal paris fondoten true match foundation d strawberry pink coolpink lover to	COL name VAL loreal paris lorsal makyaj allak farajsa	0
COL name VAL loreal paris les macarons ultra pearli maude likit luscious rose neon pembe	COL name VAL loreal paris bambi eye waterproof suya dayanakla maskara	0
COL name VAL lorsal paris brod paletvintageseasong pert belge chataigne nocolor dodd metalik bakir	COL name VAL lorsal paris color riche plump and sine ruj nektarine	0
COL name VAL loreal paris color queen tekli goz fari transcendent	COL name VAL loreal paris color queen tekli goz fari transcendent	1
COL name VAL loreal paris infaillible tam yaze uygulanabilir kapatacak cashmere	COL name VAL loreal paris true match foundation inen fondoten	0
COL name VAL loreal paris lorsal true match nude fondoten serum light	COL name VAL loreal paris true match foundation creama belge fondoten	0
COL name VAL loreal paris lorsal infaillible mat lip arayon kalem ruj flirty coffee paket x	COL name VAL loreal paris infaillible h mat cover yaksek kapatacak fondoten rose porcelain	0
COL name VAL loreal paris dudak kalemi color riche arayon lider blush fever	COL name VAL loreal paris dudak kalemi color riche arayon lider blush fever	1
COL name VAL loreal paris eye lider smokinsime superliler tupe smoke	COL name VAL loreal paris eye lider smokinsime superliler tupe smoke	1
COL name VAL loreal paris lorsal bambi eye ceylan gaz etkili maskara siyah	COL name VAL loreal paris lorsal rouge signature empowereds likit mat ruj r desiren	0
COL name VAL loreal paris infaillible h mat cover yuksek kapatici fondoten golden sand	COL name VAL loreal paris infaillible h mat cover yuksek kapatici fondoten golden sand	1
COL name VAL loreal paris color queen tekli goz fari almighty	COL name VAL loreal paris color queen tekli goz fari almighty	1
COL name VAL loreal paris true match high light aydinlatici d / w dore	COL name VAL loreal paris dore tonlarinda aydinlatici true match high light d / w golden blow	1
COL name VAL lorsal paris paradise siyah maskara	COL name VAL lorsal paris infaillible shaping stick fondoten natural rose	0
COL name VAL loreal paris miceller makyaj temizleyici bambi maskara seti	COL name VAL loreal paris miceller makyaj temizleyici bambi maskara seti	1
COL name VAL lorsal paris sparkling shell signature eye lider ink savage	COL name VAL loreal paris volume millions de cile siyah maskara	0
COL name VAL lorsal paris sicak kum signature empowereds likit red velvet sweetraspberry nocolor acce	COL name VAL lorsal paris infaillible h gaz kalemi chocolate addiction	0
COL name VAL lorsal paris color dark tekli gaz fara perceverance	COL name VAL lorsal paris mat signature eye lider copper turuncu	0
COL name VAL loreal paris accord morning light pire fr dw rusty	COL name VAL loreal paris lorsal true match bakam yapan fondoten n sand	0
COL name VAL loreal paris saat kalaca kalem no	COL name VAL loreal paris true match bakam yapan fondoten rose vanilla	0
COL name VAL loreal paris ruj infallible mega glass rasputine me	COL name VAL loreal paris ruj lip paint metallik ml lolita	0
COL name VAL loreal paris paradise siyah maskara	COL name VAL loreal paris	1
COL name VAL loreal paris love sicak fc petite mint bronzlaaytaraca pudra amali	COL name VAL lorsal paris true match kapatacak n ivory	0
COL name VAL loreal paris stick fondoten infaillible shaping peach me babem nelegantgrey	COL name VAL lorsal paris infaillible aydanlataca makyaj baza	0
COL name VAL loreal paris bronz to paradise bronzlastirici pudra baby one more tan	COL name VAL loreal paris bronz to paradise mat bronzlastirici pudra baby one more tan	1
COL name VAL loreal paris true match bakam yapan fondoten n vanilla	COL name VAL loreal paris color riche ruj mat androgyne	0
COL name VAL loreal paris eye paint goz fari no : sude boy	COL name VAL loreal paris eye paint goz fari no : sude boy	1
COL name VAL loreal paris color riche intense volume mat ruj nude independent ayna	COL name VAL loreal paris color riche intense volume mat ruj nude independent ayna	1
COL name VAL loreal paris bambi eye ceylan gaz etkili maskara iks siyah	COL name VAL loreal paris siyah eye lider smokinsime superliler black	0
COL name VAL lorsal paris infaillible shaping stick aydanlataca clightwithcoolpeachundertones is jingleballbronze	COL name VAL loreal paris kapatacak true match concealer golden honey	0
COL name VAL loreal paris mega air volume siyah maskara ml	COL name VAL loreal paris tam yaze uygulanabilir kapatacak infaillible more tan concealer rc fan	0
COL name VAL loreal paris infaillible metallik lip paint dixie	COL name VAL loreal paris infaillible metallik lip paint dixie	1
COL name VAL loreal infaillable lipstick step incessant	COL name VAL loreal infaillable lipstick step incessant	1
COL name VAL loreal paris true match bakim yapan fondoten d golden cappuccino	COL name VAL loreal paris true match bakim yapan fondoten d golden cappuccino	1
COL name VAL loreal paris color riche plump and sine ruj blue mint	COL name VAL loreal paris uzun sare kalaca fondoten infaillible h fresh wear belge rose ml	0
COL name VAL lorsal paris infaillible h concealer pomada kapatacak coy nar	COL name VAL lorsal paris color riche ruj mat mon jules	0
COL name VAL lorsal paris color riche free the rose awakenening coral sugar ravi pure pink gold sparkla doubt	COL name VAL loreal paris lorsal air volume mega easy waterproof suya dayanakla maskara siyahmask	0
COL name VAL loreal paris mat pudra infaillible h ultra prestige sand belge	COL name VAL loreal paris infaillible h ultra mat prestige pudra sand belge	1
COL name VAL loreal paris ral infmacaronsnu desenli pudra dose of ros	COL name VAL lorsal paris infaillible nudist eye paint cocku bosque	0
COL name VAL loreal paris infaillible step saat kalaca likit ruj and bal incessant russel	COL name VAL loreal paris les macarons ultra mat liquid lipstick ruj kral	0
COL name VAL lorsal paris infaillible h gaz kalemi caneli en rama addiction	COL name VAL lorsal paris la petite far paleti stilist	0
COL name VAL loreal paris tekli goz fari color queen mono eyeshadow high potential	COL name VAL loreal paris color queen tekli goz fari high potential	1
COL name VAL loreal paris rimel volume mallan lashes rougeparadoxe azel tasarim nocolor deede	COL name VAL loreal paris lorsal infaillible h fresh wear c vitaminli fondoten golden vanilla	0
COL name VAL loreal paris mega volume collagene h siyah maskara	COL name VAL lorsal paris true match allak peach	0
COL name VAL loreal paris color riche les nus ruj nu decadent	COL name VAL loreal paris color riche les nus ruj nu decadent	1
COL name VAL lorsal paris haute pink lider signature gaz kalemi noir nocolor aecfdf	COL name VAL loreal paris miceller makyaj temizleme suyu ml yaz farajsa	0
COL name VAL lorsal paris green gabiles nrainieryaz bronzlaaytaraca pudra amali mediz	COL name VAL loreal paris miceller makyaj temizleme suyu normalden ve karmaya hassas ciltler iain	0
COL name VAL loreal paris merry metal superliler gold	COL name VAL loreal paris merry metal superliler gold	1
COL name VAL loreal infaillable lipstick step toujours t	COL name VAL loreal paris rouge signature likit mat ruj i dont	0
COL name VAL loreal paris likit mat ruj les chocolate ultra liquid lipstick caca rush	COL name VAL loreal paris mat ruj paleti color riche la palette lip bold	0
COL name VAL lorsal paris bambi oversized eye maskara coolit	COL name VAL lorsal paris maskara telescopic black	0
COL name VAL loreal paris ruj infallible mega glass revolution	COL name VAL loreal paris mega glass lip revolution fabulous	1
COL name VAL loreal paris color rica ultra mat ruj no doubt	COL name VAL loreal paris gaz kalemi no kot mavisi	0
COL name VAL loreal paris mas color riche lipstick burning red	COL name VAL loreal paris mas color riche lipstick burning red	1
COL name VAL lorsal paris color queen tekli gaz fara charter	COL name VAL loreal paris kaya kalemi brod artist high contour r bony	0
COL name VAL lorsal paris nocolor fbbbce maskara sevgililer ve kadinlar gana azel tasarim	COL name VAL loreal paris wake up like this likit aydanlataca blow mon amour	0
COL name VAL loreal paris color riche saten bitisliruj orange magique turuncu	COL name VAL loreal paris kadin orange magique ruj	1
COL name VAL loreal paris mas glitter fever lider disco	COL name VAL loreal paris parlak eye lider mas glitter disco	1
COL name VAL lorsal paris infaillible eye paint gaz fara m ndamsonplum koyu kiraz	COL name VAL lorsal paris true match kapatacak n ivory	0
COL name VAL loreal paris parlatici ruj rouge signature lip hopper pure gold	COL name VAL loreal paris parlatici ruj rouge signature lip hopper pure gold	1
COL name VAL loreal paris rouge careyse irresistible expressin ruj	COL name VAL loreal paris rouge careyse irresistible expressin ruj	1
COL name VAL loreal paris mat signature eye lider ink siyah	COL name VAL loreal paris mat signature eye lider ink siyah	1
COL name VAL loreal paris suya dayanikli siyah maskara unlimited very different waterproof black	COL name VAL loreal paris unlimited very different waterproof suya dayanikli maskara	1
COL name VAL lorsal paris brod yesil dore skinny define kaya kalemi rose ivory	COL name VAL lorsal paris rouge careyse ruj cheeky macenta	0
COL name VAL loreal paris lash paradise intense black ekstra siyah maskara	COL name VAL lorsal paris infaillible tam yaze uygulanabilir kapatacak r cashmere	0
COL name VAL loreal paris no true mach allak	COL name VAL loreal paris brod artist plump and set dolgun garanam veren kaya sabitleyici maskara d bony	0
COL name VAL loreal paris x isabel marat lipstick limited edition	COL name VAL loreal paris lorsal color riche sine naked tane ruj i belge in the city nude	0
COL name VAL loreal paris mega glass lip you know loveme	COL name VAL loreal paris mega glass lip you know loveme	1
COL name VAL loreal paris true match vurgu bazli pudra parlatici high light r / c g ozel koleksiyon	COL name VAL loreal paris true match vurgu bazli pudra parlatici high light r / c g ozel koleksiyon	1
COL name VAL lorsal paris canlilar acapulco maskara	COL name VAL loreal paris kahverengi kaya kalemi brod artist designe eyebrow bencil deep brown	0
COL name VAL lorsal paris infaillible dudak kalemi apocalypse tulipgarden karmasa	COL name VAL lorsal paris infaillible eye paint gaz fara pure purple	0
COL name VAL loreal paris kahverengi aa color riche lipstick carmine saint	COL name VAL lorsal paris makyaj farajsa allak	0
COL name VAL loreal paris infaillible more tan concealer kapatici fan	COL name VAL loreal paris tum yuze uygulanabilir kapatici infaillible more tan concealer fan	1
COL name VAL loreal paris infaillible eye paint gaz fara on glass	COL name VAL loreal paris true match bakam yapan fondoten d golden natural	0