COL name VAL loreal paris superliner superstar siyah eyeliner COL market VAL 	COL name VAL loreal paris siyah eyeliner - superliner superstar COL market VAL 	1
COL name VAL loreal paris true match bakim yapan fondoten 15 linen COL market VAL 	COL name VAL loreal paris loreal paris true match bakim yapan fondoten 15 linen COL market VAL 	1
COL name VAL loreal paris likit mat ruj - les macarons ultra matte liquid lipstick 830 blackcurrant crush COL market VAL 	COL name VAL loreal paris les macarons likit mat ruj 830 blackcurrant crush COL market VAL 	1
COL name VAL loreal paris 24 saat kalici ruj infaillible 208 COL market VAL 	COL name VAL loreal paris infallible 208 lasting mauve ruj COL market VAL 	1
COL name VAL loreal paris volume million lashes fatale noir black maskara 94 ml COL market VAL 	COL name VAL loreal paris volume million lashes feline noir black maskara 92 ml COL market VAL 	0
COL name VAL loreal paris loreal true match nude serum fondoten very light fondoten fircasi seti COL market VAL 	COL name VAL loreal paris loreal true match nude serum fondoten light 360 fondoten fircasi COL market VAL 	0
COL name VAL loreal paris true match bakim yapan fondoten 5n sand fondoten COL market VAL 	COL name VAL loreal paris true match bakim yapan fondoten 5r5c5k COL market VAL 	0
COL name VAL loreal paris kas kalemi - brow artist high contour 107 cool brown COL market VAL 	COL name VAL loreal paris brow artist high contour 107 cool brunette - koyu kumral COL market VAL 	1
COL name VAL loreal paris allik - true match le blush no 160 peach COL market VAL 	COL name VAL loreal paris true match allik 160 peach COL market VAL 	1
COL name VAL loreal paris infaillible 24h matte cover yuksek kapatici fondoten 290 golden amber COL market VAL 	COL name VAL loreal paris loreal fondoten paris infaillible 24h matte cover yuksek kapatici fondoten no 290 golden amber COL market VAL 	0
COL name VAL loreal paris siyah telescopic maskara COL market VAL 	COL name VAL loreal paris siyah telescopic maskara COL market VAL 	1
COL name VAL loreal paris ruj no 134 COL market VAL 	COL name VAL loreal paris ruj - color riche lipstick 134 pink panac COL market VAL 	1
COL name VAL loreal paris loreal paris bronze to paradise mat bronzlastirici pudra 02 baby one more tan COL market VAL 	COL name VAL loreal paris loreal paris bronze to paradise mat bronzlastirici pudra - 02 baby one more tan COL market VAL 	0
COL name VAL loreal paris dudak kalemi - infaillible lip pencil 701 stay ultraviolet COL market VAL 	COL name VAL loreal paris infaillible dudak kalemi 701 stay ultraviolet- pembe COL market VAL 	1
COL name VAL loreal paris true match bakim yapan fondoten 5r5c5k COL market VAL 	COL name VAL loreal paris true match bakim yapan fondoten 1n ivory fondoten COL market VAL 	0
COL name VAL loreal paris brow artist paradise kas pomadi 104 brunette - kumral COL market VAL 	COL name VAL loreal paris jel kas pomadi - brow artist pomade no 104 brunette 30143654 COL market VAL 	1
COL name VAL loreal paris true match bakim yapan fondoten 2r rose vanilla+true match kapatici 2r/C rose vanilla 36005235001851 COL market VAL 	COL name VAL loreal paris loreal paris true match bakim yapan fondoten 2r rose vanilla+true match kapatici 2rc rose vanilla COL market VAL 	0
COL name VAL loreal paris volumissime voluminous x5 extra black extra volume mascara COL market VAL 	COL name VAL loreal paris volumissime x5 carbon black maskara - siyah COL market VAL 	1
COL name VAL loreal paris rouge signature empowereds likit mat ruj - 140 desired COL market VAL 	COL name VAL loreal paris loreal paris rouge signature empowereds likit mat ruj - 140 desired COL market VAL 	1
COL name VAL loreal paris color riche safari woman mat ruj 905 balmain instinct COL market VAL 	COL name VAL loreal paris color riche x balmain collection safari woman mat ruj 905 balmain instinct COL market VAL 	1
COL name VAL loreal paris super liner black lacquer waterproof eyeliner COL market VAL 	COL name VAL loreal paris suya dayanikli siyah eyeliner - super liner black lacquer waterproof eyeliner 6 ml COL market VAL 	1
COL name VAL loreal paris les chocolats likit mat ruj 852 box of chocolates COL market VAL 	COL name VAL loreal paris likit mat ruj - les chocolats ultra matte liquid lipstick 852 box of chocolates COL market VAL 	1
COL name VAL loreal paris color riche le sourcil kas kalemi 302 golden brown COL market VAL 	COL name VAL loreal paris kahverengi kas kalemi - brow artist designer eyebrow pencil 302 golden brown COL market VAL 	1
COL name VAL loreal paris true match bakim yapan fondoten 05n porcelain COL market VAL 	COL name VAL loreal paris loreal paris true match bakim yapan fondoten 5n sand COL market VAL 	0
COL name VAL loreal paris color riche matte addiction ruj 358 lava - kirmizi COL market VAL 	COL name VAL loreal paris mat ruj - color riche matte addiction 358 lava COL market VAL 	1
COL name VAL loreal paris color riche intense volume matte ruj - 188 rose activist COL market VAL 	COL name VAL loreal paris color riche intense volume matte ruj - 188 rose activist COL market VAL 	1
COL name VAL loreal paris true match bakim yapan fondoten 1d golden ivory COL market VAL 	COL name VAL loreal paris true match bakim yapan fondoten 1d golden ivory COL market VAL 	1
COL name VAL loreal paris ruj sexy balm 204 never stop COL market VAL 	COL name VAL loreal paris ruj sexy balm 204 never stop COL market VAL 	0
COL name VAL loreal paris bambi oversized eye maskara - siyah COL market VAL 	COL name VAL loreal paris siyah maskara bambi eye oversized black COL market VAL 	0
COL name VAL loreal paris color riche free the nudes ruj - no diktat COL market VAL 	COL name VAL loreal paris ruj - color riche free the nudes 05 no diktat COL market VAL 	1
COL name VAL loreal paris infaillible eye paint goz fari 303 breathtaking brown COL market VAL 	COL name VAL loreal paris goz fari - infallible eyeshadow paint 303 breathtaking COL market VAL 	1
COL name VAL loreal paris color riche les nus ruj 176 nu irrevent COL market VAL 	COL name VAL loreal paris loreal paris color riche les nus ruj 176 nu irrevent COL market VAL 	1
COL name VAL loreal paris goz fari quadnu p3 emeraldconquest COL market VAL 	COL name VAL loreal paris far color riche quadro p3 goz farÄ± COL market VAL 	1
COL name VAL loreal paris true match bakim yapan fondoten 05r rose porcelain COL market VAL 	COL name VAL loreal paris true match bakim yapan fondoten 05n porcelain COL market VAL 	0
COL name VAL loreal paris dudak kalemi - infaillible lip pencil 701 stay ultraviolet COL market VAL 	COL name VAL loreal paris infaillible dudak kalemi 701 stay ultraviolet- pembe COL market VAL 	1
COL name VAL loreal paris goz fari - infallible eyeshadow paint 102 irresistible COL market VAL 	COL name VAL loreal paris infaillible eye paint goz fari 102 irresistible COL market VAL 	1
COL name VAL loreal paris tekli goz fari - color queen mono eyeshadow 12 fighter 30173101 COL market VAL 	COL name VAL loreal paris tekli goz fari - color queen mono eyeshadow 12 fighter 30173101 COL market VAL 	1
COL name VAL loreal paris unlimited siyah maskara 2 li set COL market VAL 	COL name VAL loreal paris unlimited siyah maskara 2li set COL market VAL 	0
COL name VAL loreal paris loreal paris paradise siyah maskara COL market VAL 	COL name VAL loreal paris paradise siyah maskara COL market VAL 	1
COL name VAL loreal paris true match fondoten 2n vanilla COL market VAL 	COL name VAL loreal paris true match foundation 2n vanilla fondoten COL market VAL 	0
COL name VAL loreal paris infaillible 24h ruj 506 red - kirmizi COL market VAL 	COL name VAL loreal paris infaillible 24h ruj 506 red infaillible COL market VAL 	0
COL name VAL loreal paris stick allik - infaillible shaping stick allik 001 sexy flush COL market VAL 	COL name VAL loreal paris stick allik - infaillible shaping stick allik 001 sexy flush COL market VAL 	1
COL name VAL loreal paris telescopic mascara COL market VAL 	COL name VAL loreal paris loreal paris telescopic mascara maskara COL market VAL 	0
COL name VAL loreal paris true match bakim yapan fondoten 65d golden toffee COL market VAL 	COL name VAL loreal paris true match bakim yapan fondoten 55d golden sun COL market VAL 	0
COL name VAL loreal paris likit mat ruj - infaillible lip paint matte 205 apocalypse red COL market VAL 	COL name VAL loreal paris infaillible lip paint likit ruj matte 205 apocalypse red- kirmizi COL market VAL 	0
COL name VAL loreal paris true match bakim yapan fondoten 45n true beige COL market VAL 	COL name VAL loreal paris loreal paris true match bakim yapan fondoten 4n beige COL market VAL 	0
COL name VAL loreal paris loreal paris glow mon amour likit aydinlatici 02 loving peach COL market VAL 	COL name VAL loreal paris glow mon amour likit aydinlatici 02 bellini COL market VAL 	1
COL name VAL loreal paris loreal paris lash paradise intense black ekstra siyah maskara COL market VAL 	COL name VAL loreal paris lash paradise intense black ekstra siyah maskara COL market VAL 	0
COL name VAL loreal paris loreal paris true match bakim yapan fondoten 4n beige COL market VAL 	COL name VAL loreal paris true match bakim yapan fondoten 5n sand fondoten COL market VAL 	0
COL name VAL loreal paris loreal paris paradise suya dayanikli siyah maskara COL market VAL 	COL name VAL loreal paris paradise suya dayanikli siyah maskara COL market VAL 	1
COL name VAL loreal paris kas kalemi - brow artist high contour 109 ebony COL market VAL 	COL name VAL loreal paris brow artist high contour 109 ebony - esmer COL market VAL 	1
COL name VAL loreal paris micellar makyaj temizleme suyu normalden ve karmaya hassas ciltler icin 200 ml COL market VAL 	COL name VAL loreal paris loreal paris micellar makyaj temizleme suyu normalden kuruya hassas ciltler icin 200 ml COL market VAL 	0
COL name VAL loreal paris color riche plump  shine ruj 104 guava plump COL market VAL 	COL name VAL loreal paris ruj - color riche plump and shine lipstick 104 guava plump COL market VAL 	1
COL name VAL loreal paris color riche shine naked tans ruj 658 topless - nude COL market VAL 	COL name VAL loreal paris ruj - color riche shine naked tans 659 blow your glow - nude COL market VAL 	1
COL name VAL loreal paris loreal micellar makyaj temizleyici paradise intense maskara seti COL market VAL 	COL name VAL loreal paris loreal micellar makyaj temizleyici bambi maskara seti COL market VAL 	0
COL name VAL loreal paris loreal paris mega air volume siyah maskara 58 ml maskara COL market VAL 	COL name VAL loreal paris air volume mega maskara_ COL market VAL 	0
COL name VAL loreal paris brow artist high contour 105 brunette - kumral COL market VAL 	COL name VAL loreal paris paris kas kalemiaydinlatici 108 warm brunett COL market VAL 	1
COL name VAL loreal paris stick fondoten infaillible shaping stick fondoten 190 beige dore COL market VAL 	COL name VAL loreal paris infaillible shaping stick fondoten 190 beige dore COL market VAL 	0
COL name VAL loreal paris loreal perfect slim by superliner siyah eyeliner COL market VAL 	COL name VAL loreal paris perfect slim by superliner siyah eyeliner COL market VAL 	1
COL name VAL loreal paris infaillible eye paint goz fari 201 goldeneye COL market VAL 	COL name VAL loreal paris goz fari - infallible eyeshadow paint 201 golden eye COL market VAL 	1
COL name VAL loreal paris loreal paris true match bakim yapan fondoten 5n sand COL market VAL 	COL name VAL loreal paris true match bakim yapan fondoten 15 linen COL market VAL 	0
COL name VAL loreal paris true match fondoten 1r rose ivory 30ml COL market VAL 	COL name VAL loreal paris true match fondoten 1r1c1k ivory rose COL market VAL 	0
COL name VAL loreal paris loreal paris telescopic carbon black maskara - siyah x2 COL market VAL 	COL name VAL loreal paris telescopic carbon extra black maskara - siyah COL market VAL 	0
COL name VAL loreal paris les chocolats likit mat ruj 864 tasty ruby COL market VAL 	COL name VAL loreal paris les chocolats ultra matte likit ruj 864 tasty ruby COL market VAL 	1
COL name VAL loreal paris loreal paris bambi eye extra black ceylan goz etkili maskara - ekstra siyah COL market VAL 	COL name VAL loreal paris loreal paris bambi eye ceylan goz etkili maskara - siyah COL market VAL 	0
COL name VAL loreal paris loreal paris true match nude fondoten serum 05-2 very light COL market VAL 	COL name VAL loreal paris true match nude serum fondoten 2-3 light COL market VAL 	0
COL name VAL loreal paris loreal paris true match bakim yapan fondoten 4n beige COL market VAL 	COL name VAL loreal paris true match bakim yapan fondoten 1n ivory COL market VAL 	0
COL name VAL loreal paris loreal paris micellar makyaj temizleme suyu normalden kuruya hassas ciltler icin 200 ml COL market VAL 	COL name VAL loreal paris micellar makyaj temizleme suyu normalden ve karmaya hassas ciltler icin 200 ml COL market VAL 	0
COL name VAL loreal paris smoke x isabel marant goz fari paleti 6gr COL market VAL 	COL name VAL loreal paris smoke x isabel marant goz fari paleti 6gr COL market VAL 	1
COL name VAL loreal paris color queen tekli goz fari 37 extraordinnaire COL market VAL 	COL name VAL loreal paris tekli goz fari - color queen mono eyeshadow 37 extraordinnaire 30173354 COL market VAL 	1
COL name VAL loreal paris loreal paris telescopic maskara - siyah 1 paket COL market VAL 	COL name VAL loreal paris telescopic siyah maskara 2li set COL market VAL 	0
COL name VAL loreal paris loreal paris loreal paris mascara telescopic black COL market VAL 	COL name VAL loreal paris loreal paris telescopic mascara maskara COL market VAL 	0
COL name VAL loreal paris true match highlight aydinlatici 101d101w dore COL market VAL 	COL name VAL loreal paris dore tonlarinda aydinlatici - true match highlight 101d  101w golden glow COL market VAL 	1
COL name VAL loreal paris mega volume collagene 24h maskara - siyah COL market VAL 	COL name VAL loreal paris mega volume collagene 24h siyah maskara COL market VAL 	1
COL name VAL loreal paris bambi eye extra black ceylan goz etkili maskara ekstra siyah COL market VAL 	COL name VAL loreal paris loreal paris bambi eye extra black ceylan goz etkili maskara - ekstra siyah COL market VAL 	0
COL name VAL loreal paris infaillible 24h matte cover yuksek kapatici fondoten 320 toffee COL market VAL 	COL name VAL loreal paris infaillible 24h matte cover yuksek kapatici fondoten - 320 toffee COL market VAL 	1
COL name VAL loreal paris loreal paris bambi eye ceylan goz etkili maskara - siyah COL market VAL 	COL name VAL loreal paris bambi eye oversized ceylan goz etkili maskara - siyah COL market VAL 	0
COL name VAL loreal paris infaillible 24h matte cover yuksek kapatici fondoten 25 rose ivory COL market VAL 	COL name VAL loreal paris infaillible 24h matte cover yuksek kapatici fondoten - 25 rose ivory COL market VAL 	1
COL name VAL loreal paris true match bakim yapan fondoten 4d golden natural COL market VAL 	COL name VAL loreal paris fondoten true match foundation 4d golden natural 30 ml COL market VAL 	1
COL name VAL loreal paris goz fari - infallible paint nude eyeshadow peach me babe COL market VAL 	COL name VAL loreal paris infallible eye paint no 305 - peach me babe COL market VAL 	1
COL name VAL loreal paris loreal paris true match bakim yapan fondoten 7d golden amber COL market VAL 	COL name VAL loreal paris true match bakim yapan fondoten 4d golden natural COL market VAL 	0
COL name VAL loreal paris paris false lash telescopic fiber maskara COL market VAL 	COL name VAL loreal paris loreal paris false lash telescopic fiber maskara-siyah 22 g maskara COL market VAL 	0
COL name VAL loreal paris true match pudra n4 beige COL market VAL 	COL name VAL loreal paris pudra - true match powder n4 beige COL market VAL 	1
COL name VAL loreal paris loreal paris unbelieva brow micro tatouage kas kalemi - 108 dark brunette COL market VAL 	COL name VAL loreal paris unbelieva brow micro tatouage kas kalemi - 108 dark brunette COL market VAL 	1
COL name VAL loreal paris ruj - color riche free the nudes 04 no cage COL market VAL 	COL name VAL loreal paris color riche free the nudes ruj - no lies COL market VAL 	0
COL name VAL loreal paris color queen tekli goz fari 32 commander COL market VAL 	COL name VAL loreal paris loreal color queen tekli goz fari 32 commander COL market VAL 	1
COL name VAL loreal paris color riche free the nudes ruj - no prejudice COL market VAL 	COL name VAL loreal paris ruj - color riche free the nudes 12 no prejudice clrchfreends COL market VAL 	1
COL name VAL loreal paris paradise kayisi kokulu turuncu maskara COL market VAL 	COL name VAL loreal paris paradise kayisi kokulu turuncu maskara COL market VAL 	1
COL name VAL loreal paris true match nude fondoten serum 3-4 light medium COL market VAL 	COL name VAL loreal paris loreal paris true match nude fondoten serum 3-4 light medium COL market VAL 	1
COL name VAL loreal paris mascara telescopic black COL market VAL 	COL name VAL loreal paris loreal paris loreal paris mascara telescopic black COL market VAL 	0
COL name VAL loreal paris true match bakim yapan fondoten 9n truffe COL market VAL 	COL name VAL loreal paris loreal paris true match bakim yapan fondoten 4n beige COL market VAL 	0
COL name VAL loreal paris loreal paris true match bakim yapan fondoten 7d golden amber COL market VAL 	COL name VAL loreal paris true match bakim yapan fondoten 3d golden beige COL market VAL 	0
COL name VAL loreal paris kapatici - true match concealer golden honey COL market VAL 	COL name VAL loreal paris true match kapatici 6dw golden honey COL market VAL 	1
COL name VAL loreal paris telescopic carbon black maskara - siyah maskara COL market VAL 	COL name VAL loreal paris telescopic carbon extra black maskara - siyah COL market VAL 	0
COL name VAL loreal paris rouge signature likit mat ruj - 103 i enjoy COL market VAL 	COL name VAL loreal paris rouge signature matte likit ruj 113 enjoy COL market VAL 	1
COL name VAL loreal paris infaillible matte lip crayon kalem mat ruj - 102 caramel blondie COL market VAL 	COL name VAL loreal paris ruj kalem matte lip crayon 102 caramel blondie COL market VAL 	1
COL name VAL loreal paris tekli goz fari - color queen mono eyeshadow 01 unsurpassed 30172999 COL market VAL 	COL name VAL loreal paris color queen tekli goz fari 01 unsurpassed COL market VAL 	1
COL name VAL loreal paris color riche shine ruj 470 map to nirvana - mor COL market VAL 	COL name VAL loreal paris color riche shine addiction lipstick 470 map to nirvana ruj COL market VAL 	1
COL name VAL loreal paris likit kompakt fondoten - nude magique liquid cushion foundation 04 rose vanilla COL market VAL 	COL name VAL loreal paris nude magique cushion fondoten 04 rose vanilla COL market VAL 	1
COL name VAL loreal paris unlimited maskara siyah COL market VAL 	COL name VAL loreal paris unlimited siyah maskara 2li set COL market VAL 	0
COL name VAL loreal paris loreal paris makyaj allik fircasi COL market VAL 	COL name VAL loreal paris makyaj fircasi-allik fircasi COL market VAL 	1
COL name VAL loreal paris lash paradise siyah maskara COL market VAL 	COL name VAL loreal paris paradise siyah maskara COL market VAL 	0
COL name VAL loreal paris les chocolats ultra matte likit ruj 856 70 yum COL market VAL 	COL name VAL loreal paris les chocolats likit mat ruj 856 70 yum COL market VAL 	1
COL name VAL loreal paris siyah eyeliner - infallible eye stylo eyeliner 16h 301 night day black COL market VAL 	COL name VAL loreal paris infaillible 24h goz kalemi 301 night day black COL market VAL 	1
COL name VAL loreal paris true match bakim yapan fondoten 75d golden chestnut COL market VAL 	COL name VAL loreal paris loreal paris true match bakim yapan fondoten 75d golden chestnut COL market VAL 	1
COL name VAL loreal paris loreal paris mega volume collagene 24h siyah maskara COL market VAL 	COL name VAL loreal paris mega volume collagene 24h siyah maskara COL market VAL 	0
COL name VAL loreal paris bambi eye extra black ceylan goz etkili maskara ekstra siyah COL market VAL 	COL name VAL loreal paris bambi eye false lash ceylan goz etkili ekstra siyah maskara COL market VAL 	0
COL name VAL loreal paris makyaj bazi infaillible mattfying COL market VAL 	COL name VAL loreal paris infaillible resurfacing gozenek gizleyici ve puruzsuzlestirici baz COL market VAL 	1
COL name VAL loreal paris micellar makyaj temizleme suyu normalden ve karmaya hassas ciltler icin 200 ml COL market VAL 	COL name VAL loreal paris-micellar makyaj temizleme suyu normalden ve karmaya hassas ciltler icin 200 ml COL market VAL 	1
COL name VAL loreal paris infaillible 24h matte cover yuksek kapatici fondoten - 90 rose porcelain COL market VAL 	COL name VAL loreal paris infaillible 24h matte cover yuksek kapatici fondoten 155 natural rose COL market VAL 	0
COL name VAL loreal paris les macarons ultra matte likit ruj 826 mademoise COL market VAL 	COL name VAL loreal paris les macarons likit mat ruj 826 mademoiselle mango COL market VAL 	1
COL name VAL loreal paris miss baby roll siyah maskara COL market VAL 	COL name VAL loreal paris paris mega volume missbaby roll maskara black COL market VAL 	1
COL name VAL loreal paris ruj - lip paint metallic 306 lolita COL market VAL 	COL name VAL loreal paris ruj lip paint metallic 306 lolita COL market VAL 	1
COL name VAL loreal paris infaillible 24h matte fondoten 30 miel honey COL market VAL 	COL name VAL loreal paris infaillible 24h matte 30 honey 35 ml mat fondoten -3600522875413 COL market VAL 	1
COL name VAL loreal paris paradise siyah maskara COL market VAL 	COL name VAL loreal paris loreal paris paradise siyah maskara COL market VAL 	1
COL name VAL loreal paris infaillible shaping stick fondoten 130 vanilla COL market VAL 	COL name VAL loreal paris stick fondoten - infaillible shaping stick fondoten 130 vanilla COL market VAL 	1
COL name VAL loreal paris uc etkili makyaj temizleme suyu kuru - hassas ciltler 200 ml COL market VAL 	COL name VAL loreal paris kuru ve hassas ciltler icin uc etkili makyaj temizleme suyu 200 ml COL market VAL 	0
COL name VAL loreal paris color riche shine ruj 470 map to nirvana - mor COL market VAL 	COL name VAL loreal paris color riche shine addiction lipstick 470 map to nirvana COL market VAL 	1
COL name VAL loreal paris mega volume miss baby roll mascara indigo COL market VAL 	COL name VAL loreal paris kadin uzunluk saglayan mavi maskara - mega volume miss baby roll mascara indigo COL market VAL 	1
COL name VAL loreal paris ruj - infallible mega gloss 509 you know you COL market VAL 	COL name VAL loreal paris mega gloss lip gloss 509 you know you love me COL market VAL 	1
COL name VAL loreal paris true match nude serum fondoten 05-2 very light COL market VAL 	COL name VAL loreal paris loreal paris true match nude fondoten serum 05-2 very light COL market VAL 	1
COL name VAL loreal paris likit mat ruj - les macarons ultra matte liquid lipstick 826 mademoiselle mango COL market VAL 	COL name VAL loreal paris les macarons ultra matte likit ruj 826 mademoise COL market VAL 	1
COL name VAL loreal paris loreal paris color riche ruj 214 violet saturne - pembe COL market VAL 	COL name VAL loreal paris loreal color riche lipstick 214 violet saturn COL market VAL 	1
COL name VAL loreal paris true match bakim yapan fondoten 45n true beige COL market VAL 	COL name VAL loreal paris true match bakim yapan fondoten 4n beige COL market VAL 	0
COL name VAL loreal paris loreal true match foundation 5d golden sand fondoten sungeri seti COL market VAL 	COL name VAL loreal paris true match bakim yapan fondoten 5d golden sand COL market VAL 	1
COL name VAL loreal paris infaillible lip paint likit ruj matte 203 tangerine vertigo COL market VAL 	COL name VAL loreal paris likit mat ruj - infallible lip paint matte 203 tangerine vertigo COL market VAL 	1
COL name VAL loreal paris glam shine balmy gloss- 915 COL market VAL 	COL name VAL loreal paris kalem ruj no 915 COL market VAL 	1
COL name VAL loreal paris loreal paris true match bakim yapan fondoten 5n sand COL market VAL 	COL name VAL loreal paris true match bakim yapan fondoten 5n sand fondoten COL market VAL 	0
COL name VAL loreal paris loreal infaillible more than concealer kapatici 323 fawn COL market VAL 	COL name VAL loreal paris infaillible tum yuze uygulanabilir kapatici 323 fawn COL market VAL 	1
COL name VAL loreal paris loreal paris infaillible 24h fondoten 300 amber COL market VAL 	COL name VAL loreal paris infaillible 24h fondoten 300 amber COL market VAL 	1
COL name VAL loreal paris rouge signature metallic likit ruj - 206 i scintillate COL market VAL 	COL name VAL loreal paris likit metalik ruj - rouge signature metallic  206 i scintillate COL market VAL 	1
COL name VAL loreal paris micellar makyaj temizleme suyu 200 ml COL market VAL 	COL name VAL loreal paris micellar kusursuz makyaj temizleme suyu 200 ml COL market VAL 	0
COL name VAL loreal paris loreal paris true match nude fondoten serum 05-2 very light COL market VAL 	COL name VAL loreal paris true match nude serum fondoten 05-2 very light COL market VAL 	1
COL name VAL loreal paris infaillible sculpt palette kontur paleti 02 medium light COL market VAL 	COL name VAL loreal paris kontur paleti - infallible sculpt contouring palette 02 mediumlight COL market VAL 	1
COL name VAL loreal paris rouge signature empowereds likit mat ruj - 141 discovered COL market VAL 	COL name VAL loreal paris rouge signature empowereds likit mat ruj 141 discovered COL market VAL 	1
COL name VAL loreal paris color riche ruj matte 430 mon jules COL market VAL 	COL name VAL loreal paris ruj - color riche lipstick 430 mon jules COL market VAL 	1
COL name VAL loreal paris loreal color riche lipstick 214 violet saturn COL market VAL 	COL name VAL loreal paris loreal color riche lipstick 214 violet saturn COL market VAL 	0
COL name VAL loreal paris likit metalik ruj - rouge signature metallic 204 i voodoo COL market VAL 	COL name VAL loreal paris rouge signature metallic likit ruj - 204 i voodoo COL market VAL 	1
COL name VAL loreal paris tekli goz fari - color queen mono eyeshadow 27 transcendent 30173255 COL market VAL 	COL name VAL loreal paris color queen tekli goz fari 27 transcendent COL market VAL 	1
COL name VAL loreal paris kas kalemi - brow artist xpert 109 ebony COL market VAL 	COL name VAL loreal paris brow artist xpert no 109 ebony COL market VAL 	1
COL name VAL loreal paris merry metals superliner 03 gold COL market VAL 	COL name VAL loreal paris merry metals superliner 03 gold eyeliner -3600523515752 COL market VAL 	1
COL name VAL loreal paris lumimagic dw5 spf 18 fondoten COL market VAL 	COL name VAL loreal paris isilti saglayan fondoten - lumi macique foundation dw5 gold sand COL market VAL 	1
COL name VAL loreal paris ruj kalem matte lip crayon 105 sweet and salty COL market VAL 	COL name VAL loreal paris infaillible matte lip crayon kalem mat ruj - 105 sweet and salty COL market VAL 	1
COL name VAL loreal paris infaillible gel crayon 24h eyeliner 10 blue COL market VAL 	COL name VAL loreal paris mavi  infaillible gel crayon eyeliner 10 blue COL market VAL 	1
COL name VAL loreal paris true match bakim yapan fondoten 1d golden ivory COL market VAL 	COL name VAL loreal paris true match bakim yapan fondoten 1d golden ivory COL market VAL 	1
COL name VAL loreal paris true match pudra c3 rose beige COL market VAL 	COL name VAL loreal paris pudra - true match powder 3r3c rose beige COL market VAL 	1
COL name VAL loreal paris kahverengi les chocolats ultra matte liquid lipstick 860 likit mat ruj COL market VAL 	COL name VAL loreal paris les chocolats likit mat ruj 860 ginger bomb COL market VAL 	1
COL name VAL loreal paris true match bakim yapan fondoten 1n ivory COL market VAL 	COL name VAL loreal paris true match bakim yapan fondoten 1r rose ivory COL market VAL 	0
COL name VAL loreal paris isilti saglayan fondoten - lumi magique foundation c4 rose beige COL market VAL 	COL name VAL loreal paris lumi magique fondoten spf18 r-c-k4 COL market VAL 	1
COL name VAL loreal paris kapatici - true match concealer 2rc rose vanilla COL market VAL 	COL name VAL loreal paris true match kapatici 2rc rose vanilla COL market VAL 	1
COL name VAL loreal paris infaillible 24h fondoten 230 radiant honey COL market VAL 	COL name VAL loreal paris uzun sure kalici fondoten infallible 24h foundation 230 golden 30 ml COL market VAL 	1
COL name VAL loreal paris infaillible magic loose powder - transparan toz pudra COL market VAL 	COL name VAL loreal paris infaillible magic loose powder - transparan toz pudra COL market VAL 	1
COL name VAL loreal paris tum yuze uygulanabilir kapatici - infaillible more than concealer 323 fawn COL market VAL 	COL name VAL loreal paris infaillible tum yuze uygulanabilir kapatici 323 fawn COL market VAL 	1
COL name VAL loreal paris les chocolats likit mat ruj 852 box of chocolates COL market VAL 	COL name VAL loreal paris les chocolats likit mat ruj 852 box of chocolates COL market VAL 	1
COL name VAL loreal paris kontur paleti - infallible sculpt contouring palette 03 mediumdark COL market VAL 	COL name VAL loreal paris infaillible sculpt palette kontur paleti 02 medium light COL market VAL 	1
COL name VAL loreal paris rouge signature parisian sunset likit mat ruj - 130 i amaze COL market VAL 	COL name VAL loreal paris rouge signature parisian sunset likit mat ruj 130amaze COL market VAL 	1
COL name VAL loreal paris makyaj fircasi-kapatici fircasi COL market VAL 	COL name VAL loreal paris kapatici fircasi COL market VAL 	1
COL name VAL loreal paris color riche intense volume matte ruj - 640 nude independant COL market VAL 	COL name VAL loreal paris color riche intense volume matte ruj - 640 nude independant  ayna COL market VAL 	0
COL name VAL loreal paris unbelieva brow uzun sure kalici kas jeli - 109 ebony COL market VAL 	COL name VAL loreal paris loreal paris uzun sure kalici kas jeli unbelieva brow - 105 brunette COL market VAL 	0
COL name VAL loreal paris mat ruj - color riche matte addiction lipstick 346 scarlet silhouette COL market VAL 	COL name VAL loreal paris color riche matte addiction ruj 346 scarlet silhouette - kirmizi COL market VAL 	1
COL name VAL loreal paris ruj - color riche free the nudes 03 no doubts COL market VAL 	COL name VAL loreal paris loreal paris color riche free the nudes ruj - no cliche COL market VAL 	0
COL name VAL loreal paris infaillible 24h matte cover yuksek kapatici fondoten - 90 rose porcelain COL market VAL 	COL name VAL loreal paris infaillible 24h matte cover yuksek kapatici fondoten 90 rose porcelain COL market VAL 	1
COL name VAL loreal paris brow artist high contour 103 warm blond - acik sarisin COL market VAL 	COL name VAL loreal paris kas kalemi - brow artist high contour 103 warm blonde COL market VAL 	1
COL name VAL loreal paris infallible waterproof gel crayon eyeliner 07 flash silver COL market VAL 	COL name VAL loreal paris paris waterproof crayon eyeliner 07 silver COL market VAL 	1
COL name VAL loreal paris color queen tekli goz fari 20 queen COL market VAL 	COL name VAL loreal paris tekli goz fari - color queen mono eyeshadow 20 queen 30173187 COL market VAL 	1
COL name VAL loreal paris normal micellar kusursuz makyaj temizleme suyu 400 ml 2 li COL market VAL 	COL name VAL loreal paris micellar kusursuz makyaj temizleme suyu 200 ml COL market VAL 	0
COL name VAL loreal paris rouge signature likit mat ruj 105 rule COL market VAL 	COL name VAL loreal paris rouge signature likit mat ruj - 105 i rule COL market VAL 	1
COL name VAL loreal paris brow artist high contour 105 brunette  kumral COL market VAL 	COL name VAL loreal paris kas kalemi - brow artist high contour 108 warm brown COL market VAL 	1
COL name VAL loreal paris lash sensational yelpaze etkili burgundy brown maskara COL market VAL 	COL name VAL loreal paris lash sensational yelpaze etkili maskara burgundy brown COL market VAL 	1
COL name VAL loreal paris true match bakim yapan fondoten - 7d golden amber COL market VAL 	COL name VAL loreal paris loreal paris true match bakim yapan fondoten 5d golden sand COL market VAL 	0
COL name VAL loreal paris la petite far paleti - feminist COL market VAL 	COL name VAL loreal paris goz fari paleti - la petite palette feminist COL market VAL 	1
COL name VAL loreal paris bambi eye ceylan goz etkili maskara - siyah COL market VAL 	COL name VAL loreal paris bambi eye ceylan goz etkili maskara  siyah COL market VAL 	0
COL name VAL loreal paris uzun sure kalici fondoten - infaillible 24h fresh wear 120 vanilla 30 ml COL market VAL 	COL name VAL loreal paris infaillible 24h fondoten 120 vanilla COL market VAL 	1
COL name VAL loreal paris loreal true match nude serum fondoten very light fondoten fircasi seti COL market VAL 	COL name VAL loreal paris loreal true match nude serum fondoten light medium fondoten fircasi COL market VAL 	0
COL name VAL loreal paris brow artist skinny definer kas kalemi 105 brunette COL market VAL 	COL name VAL loreal paris brow artist skinny definer kas kalemi - 105 brunette COL market VAL 	1
COL name VAL loreal paris bambi eye false lash waterproof 67ml COL market VAL 	COL name VAL loreal paris bambi eye false lash waterproof 67ml COL market VAL 	0
COL name VAL loreal paris bronze please bronzlastirici pudra 03 amalfi medio COL market VAL 	COL name VAL loreal paris bronze please bronzlastirici pudra 03 amalfi COL market VAL 	1
COL name VAL loreal paris loreal paris micellar makyaj temizleme suyu normalden kuruya hassas ciltler icin 200 ml COL market VAL 	COL name VAL loreal paris micellar makyaj temizleme suyu normalden ve karmaya hassas ciltler icin 200 ml COL market VAL 	0
COL name VAL loreal paris loreal paris mega air volume siyah maskara 58 ml maskara COL market VAL 	COL name VAL loreal paris air volume mega maskara COL market VAL 	0
COL name VAL loreal paris infaillible 24h concealer pomade kapatici 02 medium - koyu ton COL market VAL 	COL name VAL loreal paris paris infaillible 24h concealer pomade kapatici 02 medium COL market VAL 	1
COL name VAL loreal paris dudak kalemi - infaillible lip pencil 101 gone with the nude COL market VAL 	COL name VAL loreal paris infaillible dudak kalemi 101 gone with the nude- nude COL market VAL 	1
COL name VAL loreal paris les chocolats ultra matte likit ruj 858 oh my choc COL market VAL 	COL name VAL loreal paris les chocolats likit mat ruj 858 oh my choc COL market VAL 	1
COL name VAL loreal paris likit mat ruj - rouge signature 104 rebel COL market VAL 	COL name VAL loreal paris rouge signature matte likit ruj 104 rebel COL market VAL 	1
COL name VAL loreal paris color riche shine ruj 112 only in paris - pembe COL market VAL 	COL name VAL loreal paris ruj - color riche shine addiction lipstick 112 only in paris COL market VAL 	1
COL name VAL loreal paris goz fari - infaillible eyeshadow paint 202 keep on khaki COL market VAL 	COL name VAL loreal paris infaillible eye paint goz fari 202 keep on khaki COL market VAL 	1
COL name VAL loreal paris true match powder w7 cinnamon COL market VAL 	COL name VAL loreal paris true match pudra n4 beige COL market VAL 	1
COL name VAL loreal paris infaillible lip paint likit ruj lacquer 103 fuschia wars COL market VAL 	COL name VAL loreal paris likit ruj - infallible lip paint lacquer 103 fuchsia wars COL market VAL 	1
COL name VAL loreal paris brow artist skinny definer kas kalemi - 104 chatain COL market VAL 	COL name VAL loreal paris brow artist skinny definer kas kalemi - 104 chatain COL market VAL 	1
COL name VAL loreal paris volume million lashes maskara COL market VAL 	COL name VAL loreal paris volume million lashes balm noir maskara COL market VAL 	0
COL name VAL loreal paris true match bakim yapan fondoten 8d golden cappuccino COL market VAL 	COL name VAL loreal paris true match bakim yapan fondoten 8d golden cappuccino COL market VAL 	1
COL name VAL loreal paris color queen tekli goz fari 21 almighty COL market VAL 	COL name VAL loreal paris color queen goz far 21 COL market VAL 	1
COL name VAL loreal paris glow mon amour likit aydinlatici 03 bronze in love COL market VAL 	COL name VAL loreal paris likit aydinlatici - glow mon amour droplet highlight 03 bronze in love COL market VAL 	1
COL name VAL loreal paris telescopic carbon black maskara - siyah COL market VAL 	COL name VAL loreal paris telescopic carbon black maskara - siyah maskara COL market VAL 	1
COL name VAL loreal paris infaillible 24h matte cover yuksek kapatici fondoten - 260 golden sun COL market VAL 	COL name VAL loreal paris infaillible 24h matte cover yuksek kapatici 260 golden sun fondoten COL market VAL 	1
COL name VAL likit aydinlatici - xmas stardust highlighting drops COL market VAL 	COL name VAL loreal paris stardust likit aydinlatici- 2018 yeni yil koleksiyonu COL market VAL 	1
COL name VAL loreal paris infaillible dudak kalemi 207 wuthering purple x2 COL market VAL 	COL name VAL loreal paris dudak kalemi - infaillible lip pencil 207 wuthering purple COL market VAL 	0
COL name VAL loreal paris true match bakim yapan fondoten 6n honey COL market VAL 	COL name VAL loreal paris true match fondoten 6n mielhoney COL market VAL 	1
COL name VAL loreal paris loreal paris uzun sure kalici kas jeli unbelieva brow - 109 ebony COL market VAL 	COL name VAL loreal paris unbelieva brow uzun sure kalici kas jeli -105 brunette COL market VAL 	0
COL name VAL loreal paris micellar kusursuz makyaj temizleme suyu hassas 400ml COL market VAL 	COL name VAL loreal paris loreal paris kusursuz makyaj temizleme suyu hassas 400 ml COL market VAL 	0
COL name VAL loreal paris true match bakim yapan fondoten 5d golden sand COL market VAL 	COL name VAL loreal paris loreal paris true match bakim yapan fondoten 5n sand COL market VAL 	0
COL name VAL loreal paris matlastirici makyaj bazi - infaillible mattifying primer COL market VAL 	COL name VAL loreal paris infaillible matlastirici makyaj bazi COL market VAL 	1
COL name VAL loreal paris loreal paris bambi eye ceylan goz etkili maskara eks siyah maskara COL market VAL 	COL name VAL loreal paris bambi eye extra black ceylan goz etkili maskara ekstra siyah 30178564 COL market VAL 	0
COL name VAL loreal infallible fresh wear 24h fondoten 60 rose ivory COL market VAL 	COL name VAL loreal paris infaillible 32h fresh wear c vitaminli fondoten - 60 rose ivory COL market VAL 	1
COL name VAL loreal paris loreal paris bambi eye ceylan goz etkili maskara eks siyah maskara COL market VAL 	COL name VAL loreal paris bambi eye extra black ceylan goz etkili maskara ekstra siyah COL market VAL 	0
COL name VAL loreal paris bambi eye ceylan goz etkili maskara siyah x 2 COL market VAL 	COL name VAL loreal paris bambi eye extra black ceylan goz etkili maskara ekstra siyah COL market VAL 	0
COL name VAL loreal paris true match bakim yapan fondoten 3d golden beige COL market VAL 	COL name VAL loreal paris true match bakim yapan fondoten 3d golden beige COL market VAL 	1
COL name VAL loreal paris jel siyah eyeliner - gel intenza 24h gel eyeliner 01 pure black COL market VAL 	COL name VAL loreal paris superliner gel intenza siyah eyeliner COL market VAL 	1
COL name VAL loreal paris infaillible 24h ruj 117 perpetual brown- kahverengi COL market VAL 	COL name VAL loreal paris 24 saat kalici ruj - infaillible rouge 117 perpetual brown COL market VAL 	1
COL name VAL loreal paris nude magique cushion fondoten 04 rose vanilla COL market VAL 	COL name VAL loreal paris likit kompakt fondoten - nude magique liquid cushion foundation 04 rose vanilla COL market VAL 	1
COL name VAL loreal paris glam shine lipstick 181 riflessione COL market VAL 	COL name VAL loreal paris ruj-glam shine reflsheer COL market VAL 	1
COL name VAL loreal paris infaillible lip paint likit ruj lacquer 102 pink lady- pembe COL market VAL 	COL name VAL loreal paris likit mat ruj - infaillible lip paint lacquer 102 darling pink COL market VAL 	1
COL name VAL loreal paris les chocolats ultra matte liquid lipstick 856 yum COL market VAL 	COL name VAL loreal paris les chocolats ultra matte likit ruj 856 70 yum COL market VAL 	1
COL name VAL loreal paris true match bakim yapan fondoten 2r rose vanilla COL market VAL 	COL name VAL loreal paris true match bakim yapan fondoten 2r rose vanilla COL market VAL 	1
COL name VAL loreal paris likit mat ruj - infallible lip paint matte 204 red actually COL market VAL 	COL name VAL loreal paris infaillible lip paint likit ruj matte 204 red actually COL market VAL 	1
COL name VAL loreal paris true match bakim yapan fondoten - 2n vanilla COL market VAL 	COL name VAL loreal paris true match bakim yapan fondoten 2n vanilla COL market VAL 	1
COL name VAL loreal paris true match bakim yapan fondoten 15 linen COL market VAL 	COL name VAL loreal paris true match bakim yapan fondoten 15 linen COL market VAL 	1
COL name VAL loreal paris loreal paris emotions of nu allik ve far paleti goz farÄ± COL market VAL 	COL name VAL loreal paris emotions of nu allik  far paleti emotions nude COL market VAL 	0
COL name VAL loreal paris ruj - color riche exclusive reds - jlos red COL market VAL 	COL name VAL loreal paris color riche ruj exclusive reds jlos pure red COL market VAL 	1
COL name VAL loreal paris likit metalik ruj - rouge signature metallic 205 i fascinate COL market VAL 	COL name VAL loreal paris rouge signature metallic likit ruj - 205 i fascinate COL market VAL 	1
COL name VAL loreal paris rouge signature metallic likit ruj - 202 i electrify COL market VAL 	COL name VAL loreal paris likit metalik ruj - rouge signature metallic 202 i electrify COL market VAL 	1
COL name VAL loreal paris kahverengi kas kalemi - brow artist designer eyebrow pencil 302 golden brown COL market VAL 	COL name VAL loreal paris color riche le sourcil kas kalemi 302 golden brown COL market VAL 	1
COL name VAL loreal paris infaillible 24h matte cover 110 rose vanilla kajal kalem seti COL market VAL 	COL name VAL loreal paris loreal infaillible 24h matte cover 110 rose vanilla kajal kalem seti COL market VAL 	0
COL name VAL loreal paris kadin no color ruj COL market VAL 	COL name VAL loreal paris color riche saten bitisliruj 125 maison marais - kirmizi COL market VAL 	1
COL name VAL loreal paris bambi eye extra black ceylan goz etkili maskara ekstra siyah 30178564 COL market VAL 	COL name VAL loreal paris loreal paris bambi eye extra black ceylan goz etkili maskara - ekstra siyah COL market VAL 	0
COL name VAL loreal paris unlimited siyah maskara 2 li set COL market VAL 	COL name VAL loreal paris loreal paris unlimited siyah maskara 2li set 1 paket 1 x 2 adet COL market VAL 	0
COL name VAL loreal paris true match allik 105 rose pastel COL market VAL 	COL name VAL loreal paris true match le blush no 105 rose pastel allik COL market VAL 	1
COL name VAL loreal paris goz fari - infaillible eyeshadow paint 101 eternal white COL market VAL 	COL name VAL loreal paris infaillible eye paint goz fari 101 eternal white COL market VAL 	1
COL name VAL loreal paris color riche les nus ruj 179 nu decadent COL market VAL 	COL name VAL loreal paris loreal paris color riche les nus ruj - 179 nu decadent COL market VAL 	0
COL name VAL loreal paris rouge signature likit mat ruj 114 i represent COL market VAL 	COL name VAL loreal paris rouge signature likit mat ruj - 114 i represent COL market VAL 	1
COL name VAL loreal paris brow artist kas kalemi 105 brunette  kapatici 327 cashmere  makyaj organizeri COL market VAL 	COL name VAL loreal paris brow artist kas kalemi 105 brunette  kapatici 327 cashmere  makyaj organizeri 301736201 COL market VAL 	0
COL name VAL loreal paris loreal paris paradise maskara siyah maskara COL market VAL 	COL name VAL loreal paris paradise extatic siyah maskara COL market VAL 	0
COL name VAL loreal paris loreal paris true match nude fondoten serum 2-3 light COL market VAL 	COL name VAL loreal paris true match nude serum fondoten 05-2 very light COL market VAL 	0
COL name VAL loreal paris unlimited siyah maskara 2li set  ayna COL market VAL 	COL name VAL loreal paris loreal paris unlimited siyah maskara 2li set 1 paket 1 x 2 adet COL market VAL 	0
COL name VAL loreal paris infaillible magic setting makyaj sabitleyici sprey COL market VAL 	COL name VAL loreal paris infaillible magic setting makyaj sabitleyici sprey COL market VAL 	1
COL name VAL loreal paris ceylan goz etkili ekstar maskara siyah  maybelline new york kajal goz kalemi COL market VAL 	COL name VAL loreal paris loreal ceylan goz etkili ekstar siyah maskaramaybelline kajal goz kalemi COL market VAL 	1
COL name VAL loreal paris color riche matte addiction ruj 634 greige perfecto - kahverengi COL market VAL 	COL name VAL loreal paris mat ruj - color riche matte addiction lipstick 634 geige hype COL market VAL 	1
COL name VAL loreal paris likit mat ruj - infaillible lip paint lacquer 102 darling pink COL market VAL 	COL name VAL loreal paris infaillible lip paint likit ruj lacquer 102 pink lady- pembe COL market VAL 	1
COL name VAL loreal paris lash paradise waterproof suya dayanikli maskara 64ml COL market VAL 	COL name VAL loreal paris lash paradise waterproofsuya dayanikli maskara 64ml COL market VAL 	0
COL name VAL loreal paris bambi eye ceylan goz etkili maskara  siyah COL market VAL 	COL name VAL loreal paris bambi eye ceylan goz etkili maskara - siyah x2 COL market VAL 	0
COL name VAL loreal paris infaillible tum yuze uygulanabilir kapatici 327 cashmere COL market VAL 	COL name VAL loreal paris infaillible tum yuze uygulanabilir kapatici 322 ivory COL market VAL 	0
COL name VAL loreal paris yesil eyeliner - infaillible gel crayon eyeliner 08 kaki COL market VAL 	COL name VAL loreal paris infaillible paint gel crayon eyeliner 08 rest in kaki COL market VAL 	1
COL name VAL loreal paris infaillible 24h matte fondoten 24 beige dore COL market VAL 	COL name VAL loreal paris mat fondoten - infaillible 24h matte 24 golden beige 35 ml COL market VAL 	1
COL name VAL loreal paris true match bakim yapan fondoten 1d golden ivory COL market VAL 	COL name VAL loreal paris true match bakim yapan fondoten 1n ivory COL market VAL 	0
COL name VAL loreal paris loreal paris infaillible 24h fondoten 230 radiant honey COL market VAL 	COL name VAL loreal paris infaillible 24h fondoten 230 radiant honey COL market VAL 	1
COL name VAL loreal paris brow artist skinny definer kas kalemi 104 chatain COL market VAL 	COL name VAL loreal paris brow artist skinny definer kas kalemi - 104 chatain COL market VAL 	1
COL name VAL loreal paris loreal paris true match bakim yapan fondoten 4n beige COL market VAL 	COL name VAL loreal paris true match bakim yapan fondoten 5n sand COL market VAL 	0
COL name VAL loreal paris brow artist plumpset renkli kas sabitleyici maskara - 108 dark brunette COL market VAL 	COL name VAL loreal paris kas serumu brow asist plumo  set 108 dark brunette COL market VAL 	1
COL name VAL loreal paris color queen tekli goz fari 17 COL market VAL 	COL name VAL loreal paris loreal color queen tekli goz fari 20 queen COL market VAL 	0
COL name VAL loreal paris true match pudra 4n beige COL market VAL 	COL name VAL loreal paris pudra - true match powder 2r2c rose vanilla COL market VAL 	1
COL name VAL loreal paris true match bakim yapan fondoten 5r rose sand COL market VAL 	COL name VAL loreal paris true match bakim yapan fondoten 2r rose COL market VAL 	0
COL name VAL loreal paris rouge caresse - ruj 07 cheeky magenta COL market VAL 	COL name VAL loreal paris ruj - labial color riche caresse lipstick 07 cheeky magenta COL market VAL 	1
COL name VAL loreal paris goz fari - infallible paint eyeshadow 401 metal copp COL market VAL 	COL name VAL loreal paris infaillible metallic eye paint 401 metallic copper COL market VAL 	1
COL name VAL loreal paris loreal paris true match bakim yapan fondoten 7r rose amber COL market VAL 	COL name VAL loreal paris true match bakim yapan fondoten 7r rose amber COL market VAL 	1
COL name VAL loreal paris likit mat ruj - les macarons ultra matte liquid lipstick 822 mon caramel COL market VAL 	COL name VAL loreal paris les macarons likit mat ruj 822 mon caramel COL market VAL 	1
COL name VAL loreal paris superliner ultra precision siyah eyeliner COL market VAL 	COL name VAL loreal paris siyah eyeliner - ultra precision superliner 01 COL market VAL 	1
COL name VAL loreal paris loreal paris infaillible 24h tum yuze uygulanabilir kapatici - 326 vanilla COL market VAL 	COL name VAL loreal paris infaillible tum yuze uygulanabilir kapatici 326 vanilla COL market VAL 	1
COL name VAL loreal paris true match bakim yapan fondoten 5r rose sand COL market VAL 	COL name VAL loreal paris loreal paris true match bakim yapan fondoten 05r rose porcelain COL market VAL 	0
COL name VAL loreal paris unbelieva brow uzun sure kalici kas jeli -105 brunette COL market VAL 	COL name VAL loreal paris loreal paris uzun sure kalici kas jeli unbelieva brow - 105 brunette COL market VAL 	1
COL name VAL loreal paris le liner signature goz kalemi 02 blue jersey COL market VAL 	COL name VAL loreal paris le liner signature mavi goz kalemi 02 COL market VAL 	1
COL name VAL loreal paris true match bakim yapan fondoten 2r rose vanilla+true match kapatici 2n vanilla COL market VAL 	COL name VAL loreal paris true match bakim yapan fondoten 2r rose vanilla COL market VAL 	0
COL name VAL loreal paris color riche shine addiction ruj 906 girlsnight COL market VAL 	COL name VAL loreal paris - ruj - color riche shine addiction lipstick 906 girls night COL market VAL 	1
COL name VAL loreal paris true match bakim yapan fondoten 4n beige COL market VAL 	COL name VAL loreal paris loreal paris true match bakim yapan fondoten 15 linen COL market VAL 	0
COL name VAL loreal paris loreal perfect slim by superliner siyah eyeliner COL market VAL 	COL name VAL loreal paris superliner perfect slim siyah eyeliner COL market VAL 	0
COL name VAL loreal paris paris siyah eyeliner - smokissime superliner 100 black COL market VAL 	COL name VAL loreal paris superliner smokissime eyeliner black COL market VAL 	0
COL name VAL loreal paris infaillible 24h fondoten 125 natural rose COL market VAL 	COL name VAL loreal paris fondoten - infallible fond16h natural rose 125 COL market VAL 	1
COL name VAL loreal paris pudra - true match powder w7 cinnamon COL market VAL 	COL name VAL loreal paris true match powder w7 cinnamon COL market VAL 	1
COL name VAL loreal paris infaillible lip paint likit ruj matte 205 apocalypse red- kirmizi COL market VAL 	COL name VAL loreal paris likit mat ruj - infaillible lip paint matte 205 apocalypse red COL market VAL 	0
COL name VAL loreal paris loreal paris unlimited siyah maskara 2li set 1 paket 1 x 2 adet COL market VAL 	COL name VAL loreal paris unlimited siyah maskara 2li set  ayna COL market VAL 	0
COL name VAL loreal paris true match bakim yapan fondoten 1d golden ivory COL market VAL 	COL name VAL loreal paris true match bakim yapan fondoten 1d golden ivory COL market VAL 	1
COL name VAL loreal paris true match bakim yapan fondoten 4n beige COL market VAL 	COL name VAL loreal paris loreal paris true match bakim yapan fondoten 4n beige COL market VAL 	0
COL name VAL loreal paris cest magic bb krem 05 medium dark COL market VAL 	COL name VAL loreal paris cest magic bb krem 05 medium dark COL market VAL 	0
COL name VAL loreal paris smoke x isabel marant goz fari paleti 6gr COL market VAL 	COL name VAL loreal paris smoke x isabel marant goz fari paleti 6gr COL market VAL 	1
COL name VAL loreal paris loreal paris color riche plump  shine ruj COL market VAL 	COL name VAL loreal paris color riche plump  shine ruj 109 blue mint plump COL market VAL 	0
COL name VAL loreal paris color riche saten bitisli ruj 143 pink pigalle - pembe COL market VAL 	COL name VAL loreal paris loreal paris color riche saten bitisli ruj 143 pink pigalle - pembe COL market VAL 	0
COL name VAL loreal paris infaillible 24h matte cover yuksek kapatici fondoten - 200 golden sand COL market VAL 	COL name VAL loreal paris infaillible 24h matte cover yuksek kapatici fondoten 200 golden sand COL market VAL 	1
COL name VAL loreal paris ruj kalem matte lip crayon 103 maple dream COL market VAL 	COL name VAL loreal paris infaillible matte lip crayon kalem mat ruj - 103 maple dream COL market VAL 	1
COL name VAL loreal paris loreal paris telescopic mascara maskara COL market VAL 	COL name VAL loreal paris loreal paris loreal paris mascara telescopic black COL market VAL 	0
COL name VAL loreal paris color riche matte addiction ruj 636 mahogany studs - kahverengi COL market VAL 	COL name VAL loreal paris mat ruj - color riche matte addiction lipstick 636 mahogandy studs COL market VAL 	1
COL name VAL loreal paris siyah maskara - false lash butterfly effect intenza COL market VAL 	COL name VAL loreal paris wings intenza siyah maskara COL market VAL 	1
COL name VAL loreal paris loreal true match nude serum fondoten very light fondoten fircasi seti COL market VAL 	COL name VAL loreal paris loreal true match nude serum fondoten very light fondoten fircasi seti COL market VAL 	0
COL name VAL loreal paris infaillible dudak kalemi 207 wuthering purple- murdum COL market VAL 	COL name VAL loreal paris dudak kalemi - infaillible lip pencil 207 wuthering purple COL market VAL 	1
COL name VAL loreal paris true match bakim yapan fondoten 4d golden natural COL market VAL 	COL name VAL loreal paris true match bakim yapan fondoten 4d golden natural COL market VAL 	1
COL name VAL loreal paris bambi eye ceylan goz etkili siyah maskara COL market VAL 	COL name VAL loreal paris loreal paris bambi eye ceylan goz etkili maskara siyah 89 ml COL market VAL 	0
COL name VAL loreal paris stick aydinlatici infaillible shaping stick 503 slay in rose COL market VAL 	COL name VAL loreal paris infaillible shaping stick aydinlatici 503 slay in rose COL market VAL 	1
COL name VAL loreal paris color riche matte addiction ruj 655 copper clutch - kahverengi COL market VAL 	COL name VAL loreal paris color riche matte addiction ruj 655 copper clutch COL market VAL 	1
COL name VAL loreal paris telescopic maskara - siyah COL market VAL 	COL name VAL loreal paris loreal paris telescopic maskara - siyah 1 paket COL market VAL 	0
COL name VAL loreal paris-micellar makyaj temizleme suyu normalden ve karmaya hassas ciltler icin 200 ml COL market VAL 	COL name VAL loreal paris micellar makyaj temizleme suyu normalden ve karmaya hassas ciltler icin 200 ml COL market VAL 	0
COL name VAL loreal paris true match nude serum fondoten 2-3 light COL market VAL 	COL name VAL loreal paris loreal paris true match nude fondoten serum 3-4 light medium COL market VAL 	0
COL name VAL loreal paris aydinlatici paleti 02 cool glowlionesse barbie makyaj fircasi 002 COL market VAL 	COL name VAL loreal paris aydinlatici paleti 02 cool glowlionesse barbie makyaj fircasi 002 COL market VAL 	0
COL name VAL loreal paris infaillible eye liner 306 stay blue COL market VAL 	COL name VAL loreal paris infaillible eye liner 306 stay blue COL market VAL 	1
COL name VAL loreal paris true match bakim yapan fondoten 55d golden sun COL market VAL 	COL name VAL loreal paris loreal paris true match bakim yapan fondoten 7d golden amber COL market VAL 	0
COL name VAL loreal paris pudra - true match powder 3r3c rose beige COL market VAL 	COL name VAL loreal paris true match - pudra COL market VAL 	1
COL name VAL loreal paris infaillible gel crayon goz kalemi 01 back to black - siyah COL market VAL 	COL name VAL loreal paris siyah eyeliner - infaillible gel crayon eyeliner 01 black COL market VAL 	1
COL name VAL loreal paris infaillible eye paint goz fari 102 irresistible rose COL market VAL 	COL name VAL loreal paris goz fari - infallible eyeshadow paint 102 irresistible COL market VAL 	1
COL name VAL loreal paris loreal paris paradise siyah maskara 64 ml COL market VAL 	COL name VAL loreal paris loreal paris lash paradise siyah maskara COL market VAL 	0
COL name VAL loreal paris true match bakim yapan fondoten 4n beige COL market VAL 	COL name VAL loreal paris true match bakim yapan fondoten 4n beige COL market VAL 	1
COL name VAL loreal expert loreal paris infaillible 24h fondoten 200 golden sand COL market VAL 	COL name VAL loreal paris infaillible 24h fondoten 200 golden sand COL market VAL 	0
COL name VAL loreal paris kahverengi eyeliner - infaillible gel crayon eyeliner 05 cooper COL market VAL 	COL name VAL loreal paris infaillible gel crayon goz kalemi 05 super cooper - bakir COL market VAL 	1
COL name VAL loreal paris dore tonlarinda aydinlatici - true match highlight 101d  101w golden glow COL market VAL 	COL name VAL loreal paris true match highlight aydinlatici 101d101w dore COL market VAL 	1
COL name VAL loreal paris infaillible 24h ruj 209 violet parfait COL market VAL 	COL name VAL loreal paris 24 saat kalici ruj - infaillible rouge 209 violet parfait COL market VAL 	1
COL name VAL loreal paris true match kapatici 3n creamy beige COL market VAL 	COL name VAL loreal paris true match kapatici 3n creamy beige COL market VAL 	1
COL name VAL loreal paris mat ruj - color riche matte addiction 655 copper clutch COL market VAL 	COL name VAL loreal paris color riche matte addiction ruj 655 copper clutch - kahverengi COL market VAL 	1
COL name VAL loreal paris rouge signature lip topper dudak parlatici ruj - 211 rose gold COL market VAL 	COL name VAL loreal paris parlatici ruj - rouge signature lip topper 211 rose gold COL market VAL 	1
COL name VAL loreal paris likit mat ruj - les chocolats ultra matte liquid lipstick 868 cacao rush COL market VAL 	COL name VAL loreal paris les chocolats ultra matte likit ruj 868 cacao crush COL market VAL 	1
COL name VAL loreal paris siyah maskara - miss manga COL market VAL 	COL name VAL loreal paris mega volume miss manga maskara COL market VAL 	1
COL name VAL loreal paris loreal paris true match bakim yapan fondoten 4n beige COL market VAL 	COL name VAL loreal paris true match bakim yapan fondoten 4n beige COL market VAL 	1
COL name VAL loreal paris infaillible eye paint goz fari 302 immortal black COL market VAL 	COL name VAL loreal paris goz fari - infallible eyeshadow paint 302 immortal black COL market VAL 	1
COL name VAL loreal paris siyah superliner black lacquer waterproof eyeliner COL market VAL 	COL name VAL loreal paris superliner black lacquer waterproof eyeliner - siyah COL market VAL 	0
COL name VAL loreal paris brow artist high contour 103 warm blond - acik sarisin COL market VAL 	COL name VAL loreal paris kas kalemi - brow artist high contour 103 warm blonde COL market VAL 	1
COL name VAL loreal paris rouge signature likit mat ruj - 115 i am worth it COL market VAL 	COL name VAL loreal paris rouge signature likit mat ruj - 115 i am worth it COL market VAL 	1
COL name VAL loreal paris loreal paris true match bakim yapan fondoten 05r rose porcelain COL market VAL 	COL name VAL loreal paris true match bakim yapan fondoten 05n porcelain COL market VAL 	0
COL name VAL loreal paris loreal paris paradise suya dayanikli siyah maskara COL market VAL 	COL name VAL loreal paris paradise suya dayanikli siyah maskara COL market VAL 	1
COL name VAL loreal paris true match bakim yapan fondoten 15 linen COL market VAL 	COL name VAL loreal paris true match bakim yapan fondoten 15 linen COL market VAL 	1
COL name VAL loreal paris infaillible 24h matte cover yuksek kapatici fondoten - 130 true beige COL market VAL 	COL name VAL loreal paris infaillible 24h matte cover yuksek kapatici fondoten 130 true beige COL market VAL 	1
COL name VAL loreal paris true match bakim yapan fondoten 45n true beige COL market VAL 	COL name VAL loreal paris true match bakim yapan fondoten 45n true beige COL market VAL 	1
COL name VAL loreal paris likit mat ruj - les macarons ultra matte liquid lipstick 830 blackcurrant crush 360052 COL market VAL 	COL name VAL loreal paris les macarons likit mat ruj 830 blackcurrant crush COL market VAL 	1
COL name VAL loreal paris infaillible 24h fondoten 140 golden beige COL market VAL 	COL name VAL loreal paris loreal paris infaillible 32h fresh wear c vitaminli fondoten - 140 golden beige COL market VAL 	1
COL name VAL loreal paris true match bakim yapan fondoten 1n ivory COL market VAL 	COL name VAL loreal paris true match bakim yapan fondoten 1d golden ivory COL market VAL 	0
COL name VAL loreal paris likit mat ruj - les macarons ultra matte liquid lipstick 832 strawberry sauvage COL market VAL 	COL name VAL loreal paris les macarons likit mat ruj 832 strawberry sauvage COL market VAL 	1
COL name VAL loreal paris loreal fondoten paris infaillible 24h matte cover yuksek kapatici fondoten no 290 golden amber COL market VAL 	COL name VAL loreal paris infaillible 24h matte cover yuksek kapatici fondoten 115 golden beige COL market VAL 	0
COL name VAL loreal paris kas kalemi - brow artist xpert 107 cool brune COL market VAL 	COL name VAL loreal paris brow artist xpert no 107 cool brunette COL market VAL 	1
COL name VAL loreal paris infaillible 24h matte cover 110 rose vanilla  kajal kalem seti COL market VAL 	COL name VAL loreal paris loreal infaillible 24h matte cover 110 rose vanilla kajal kalem seti COL market VAL 	0
COL name VAL loreal paris loreal paris glow paradise balm-in-lipstick - isilti veren ruj 642 beige eden COL market VAL 	COL name VAL loreal paris color riche shine ruj 642 mlbb - nude COL market VAL 	1
COL name VAL loreal paris loreal paris telescopic maskara - siyah 1 paket COL market VAL 	COL name VAL loreal paris telescopic siyah maskara 2li set COL market VAL 	0
COL name VAL loreal paris maskara COL market VAL 	COL name VAL loreal paris bambi eye ceylan goz etkili suya dayanikli maskara - siyah 30178625 COL market VAL 	1
COL name VAL loreal paris loreal true match nude serum fondoten light fondoten fircasi COL market VAL 	COL name VAL loreal paris loreal paris true match nude fondoten serum 2-3 light COL market VAL 	0
COL name VAL loreal paris infaillible tum yuze uygulanabilir kapatici 322 ivory COL market VAL 	COL name VAL loreal paris loreal paris infaillible tum yuze uygulanabilir kapatici 338 honey COL market VAL 	0
COL name VAL loreal paris color riche matte addiction ruj 654 bronze sautoir - kahverengi COL market VAL 	COL name VAL loreal paris mat ruj - color riche matte addiction 654 bronze sautoir COL market VAL 	1
COL name VAL loreal paris loreal paris bambi eye ceylan goz etkili maskara - siyah COL market VAL 	COL name VAL loreal paris bambi eye extra black ceylan goz etkili maskara ekstra siyah COL market VAL 	0
COL name VAL loreal paris tekli goz fari - color queen mono eyeshadow 13 dignity 30173118 COL market VAL 	COL name VAL loreal paris color queen tekli goz fari 13 dignity COL market VAL 	1
COL name VAL loreal paris likit mat ruj - les chocolats ultra matte liquid lipstick 852 box of chocolates COL market VAL 	COL name VAL loreal paris les chocolats likit mat ruj 852 box of chocolates COL market VAL 	1
COL name VAL loreal paris unbelieva brow uzun sure kalici seffaf kas maskarasi COL market VAL 	COL name VAL loreal paris loreal paris unbelieva brow uzun sure kalici seffaf kas maskarasi COL market VAL 	0
COL name VAL loreal paris la vie en glow aydinlatici paleti cool glow - soguk tonlar COL market VAL 	COL name VAL loreal paris la vie en glow highlighting powder pallette cool glow aydinlatici paleti COL market VAL 	1
COL name VAL loreal true match foundation 1n ivory fondoten sungeri seti COL market VAL 	COL name VAL loreal paris loreal true match foundation 1rc rose ivory fondoten sungeri seti COL market VAL 	0
COL name VAL loreal paris cest magic bb krem 03 medium light COL market VAL 	COL name VAL loreal paris cest magic bb krem 03 medium light COL market VAL 	1
COL name VAL loreal paris - color riche crayon liner 461 scarlet rouge dudak kalemi COL market VAL 	COL name VAL loreal paris color riche dudak kalemi 461 scarlet rouge COL market VAL 	1
COL name VAL loreal paris bambi eye ceylan goz etkili maskara siyah 89 ml COL market VAL 	COL name VAL loreal paris loreal paris bambi eye ceylan goz etkili maskara - siyah COL market VAL 	0
COL name VAL loreal paris true match bakim yapan fondoten 4d golden natural COL market VAL 	COL name VAL loreal paris true match bakim yapan fondoten 4d golden natural COL market VAL 	1
COL name VAL loreal paris loreal paris lash paradise intense black ekstra siyah maskara COL market VAL 	COL name VAL loreal paris lash paradise intense black ekstra siyah maskara 2li set ve ayna COL market VAL 	0
COL name VAL loreal paris loreal paris true match bakim yapan fondoten 7d golden amber COL market VAL 	COL name VAL loreal paris true match bakim yapan fondoten 6d golden honey COL market VAL 	0
COL name VAL loreal paris true match nude serum fondoten 05-2 very light COL market VAL 	COL name VAL loreal paris loreal paris true match nude fondoten serum 2-3 light COL market VAL 	0
COL name VAL loreal paris true match bakim yapan fondoten 1n ivory COL market VAL 	COL name VAL loreal paris true match bakim yapan fondoten 1n ivory COL market VAL 	1
COL name VAL loreal paris loreal paris bambi eye ceylan goz etkili maskara - siyah COL market VAL 	COL name VAL loreal paris loreal paris bambi eye extra black ceylan goz etkili maskara - ekstra siyah COL market VAL 	0
COL name VAL loreal paris matte signature eyeliner 01 ink - siyah COL market VAL 	COL name VAL loreal paris mat eyeliner - matte signature eyeliner 01 ink COL market VAL 	1
COL name VAL loreal paris emotions of nu allik  far paleti COL market VAL 	COL name VAL loreal paris emotions of nu allik amp far paleti COL market VAL 	1
COL name VAL loreal paris loreal paris true match nude fondoten serum 05-2 very light COL market VAL 	COL name VAL loreal paris true match nude fondoten serum 2-3 light COL market VAL 	0
COL name VAL loreal paris infaillible 24h fresh wear pudra fondoten 220 sand COL market VAL 	COL name VAL loreal paris infaillible 24h fresh wear pudra fondoten 180 rose sand COL market VAL 	0
COL name VAL loreal paris bambi eye extra black ceylan goz etkili maskara ekstra siyah COL market VAL 	COL name VAL loreal paris bambi eye ceylan goz etkili maskara  siyah COL market VAL 	0
COL name VAL loreal paris color riche intense volume matte ruj - 602 nude admirable  ayna COL market VAL 	COL name VAL loreal paris color riche intense volume matte ruj - 602 nude admirable COL market VAL 	0
COL name VAL loreal paris true match bakim yapan fondoten 15 linen COL market VAL 	COL name VAL loreal paris true match bakim yapan fondoten 15 linen COL market VAL 	1
COL name VAL loreal paris ruj - color riche exclusive reds - evas red COL market VAL 	COL name VAL loreal paris color riche ruj exclusive reds evas pure red COL market VAL 	1
COL name VAL loreal paris ruj - color riche free the nudes 05 no diktat COL market VAL 	COL name VAL loreal paris color richa ultra matte mat ruj no 6 hesitation COL market VAL 	1
COL name VAL loreal paris glow paradise ruj balm-in-lipstick 244 apricot desire-kayisi  3600523687114-244 COL market VAL 	COL name VAL loreal paris color riche plump  shine ruj 101 nectarine plump COL market VAL 	1
COL name VAL loreal paris loreal paris true match nude fondoten serum 3-4 light medium COL market VAL 	COL name VAL loreal paris true match nude serum fondoten 2-3 light COL market VAL 	0
COL name VAL loreal paris likit mat ruj - les macarons ultra matte liquid lipstick 830 blackcurrant crush 360052 COL market VAL 	COL name VAL loreal paris les macarons ultra matte likit ruj 830 blackcurrant COL market VAL 	1
COL name VAL loreal paris loreal paris infaillible tum yuze uygulanabilir kapatici 326 vanilla COL market VAL 	COL name VAL loreal paris infaillible tum yuze uygulanabilir kapatici 326 vanilla COL market VAL 	1
COL name VAL loreal paris superstar maskara false lash 01 siyah COL market VAL 	COL name VAL loreal paris siyah maskara lash superstar mascara black 5 ml COL market VAL 	1
COL name VAL loreal paris tekli goz fari - color queen mono eyeshadow 20 queen 30173187 COL market VAL 	COL name VAL loreal paris tekli goz fari - color queen mono eyeshadow 12 fighter 30173101 COL market VAL 	0
COL name VAL loreal paris loreal paris bambi eye ceylan goz etkili maskara eks siyah maskara COL market VAL 	COL name VAL loreal paris siyah bambi eye oversized ceylan goz etkili maskara COL market VAL 	0
COL name VAL loreal paris true match nude fondoten serum 3-4 light medium COL market VAL 	COL name VAL loreal paris loreal paris true match nude fondoten serum 2-3 light COL market VAL 	0
COL name VAL loreal paris ruj  color riche shine addiction lipstick 350 insanesation COL market VAL 	COL name VAL loreal paris color riche shine ruj 350 insanesation - kirmizi COL market VAL 	1
COL name VAL loreal infaillible 24h fresh wear pudra fondoten 40 cashmere COL market VAL 	COL name VAL loreal paris infaillible 24h fresh wear pudra fondoten 40 cashmere COL market VAL 	1
COL name VAL loreal paris infaillible 24h fondoten 220 sand COL market VAL 	COL name VAL loreal paris infaillible 24h fondoten - 220 sand COL market VAL 	1
COL name VAL loreal paris loreal micellar makyaj temizleyici paradise intense maskara seti COL market VAL 	COL name VAL loreal paris loreal micellar makyaj temizleyici paradise intense maskara seti COL market VAL 	0
COL name VAL loreal paris infaillible 24h ruj 121 flawless fuschia COL market VAL 	COL name VAL loreal paris loreal paris infaillible 24h ruj 121 flawless fuschia COL market VAL 	1
COL name VAL loreal paris rouge signature likit mat ruj - 112 i achieve COL market VAL 	COL name VAL loreal paris rouge signature matte likit ruj 112 achieve COL market VAL 	1
COL name VAL loreal paris true match bakim yapan fondoten 45n true beige COL market VAL 	COL name VAL loreal paris loreal paris true match bakim yapan fondoten 4n beige COL market VAL 	0
COL name VAL loreal paris le liner signature goz kalemi 01 noir cashmere 30176447 COL market VAL 	COL name VAL loreal paris le liner signature goz kalemi 01 noir cashmere COL market VAL 	1
COL name VAL loreal paris true match kapatici 02 vanilla COL market VAL 	COL name VAL loreal paris kapatici - true match concealer 02 vanilla COL market VAL 	1
COL name VAL loreal paris true match kapatici 2rc rose vanilla COL market VAL 	COL name VAL loreal paris kapatici - true match concealer 2rc rose vanilla COL market VAL 	1
COL name VAL loreal paris super liner black lacquer waterproof eyeliner COL market VAL 	COL name VAL loreal paris superliner black lacquer waterproof eyeliner - siyah COL market VAL 	1
COL name VAL loreal paris infaillible 24h matte cover yuksek kapatici fondoten 300 amber COL market VAL 	COL name VAL loreal paris loreal paris infaillible 24h matte cover yuksek kapatici fondoten no 300 amber COL market VAL 	0
COL name VAL loreal paris loreal paris true match bakim yapan fondoten 4n beige COL market VAL 	COL name VAL loreal paris true match bakim yapan fondoten 1n ivory COL market VAL 	0
COL name VAL loreal paris true match bakim yapan fondoten 45n true beige COL market VAL 	COL name VAL loreal paris true match bakim yapan fondoten 45n true beige COL market VAL 	1
COL name VAL loreal paris mega volume collagene 24h siyah maskara COL market VAL 	COL name VAL loreal paris mega volume collagene 24h maskara - siyah COL market VAL 	1
COL name VAL loreal paris true match bakim yapan fondoten 4d golden natural COL market VAL 	COL name VAL loreal paris loreal paris true match bakim yapan fondoten 5d golden sand COL market VAL 	0
COL name VAL loreal paris merry metals superliner 03 gold COL market VAL 	COL name VAL loreal paris eyeliner - merry metals superliner 03 gold COL market VAL 	1
COL name VAL loreal paris rimel volume million lashes cannes ozel tasarim siyah COL market VAL 	COL name VAL loreal paris volume million lashes maskara cannes koleksiyonu ozel tasarim COL market VAL 	1
COL name VAL loreal paris infaillible 24h fondoten 150 radiant eclat COL market VAL 	COL name VAL loreal paris uzun sure kalici fondoten - infallible 24h foundation 150 beige 30 ml COL market VAL 	1
COL name VAL loreal paris color riche plump  shine ruj 104 guava plump COL market VAL 	COL name VAL loreal paris loreal paris color riche plump  shine ruj COL market VAL 	0
COL name VAL loreal paris kadin no color ruj COL market VAL 	COL name VAL loreal paris color riche ruj no125 maison marais COL market VAL 	1
COL name VAL loreal paris kadin pembe allik - wake up and glow blush 03 melon dollar baby COL market VAL 	COL name VAL loreal paris melon dollar embel blush 03 watermelon COL market VAL 	1
COL name VAL loreal paris ruj - color riche free the nudes 04 no cage COL market VAL 	COL name VAL loreal paris loreal paris color riche free the nudes ruj - no cliche COL market VAL 	0
COL name VAL loreal paris infaillible 24h matte cover yuksek kapatici fondoten 155 natural rose COL market VAL 	COL name VAL loreal paris infaillible 24h matte cover yuksek kapatici fondoten - 155 natural rose COL market VAL 	1
COL name VAL loreal paris ruj - lip paint metallic 305 cute but COL market VAL 	COL name VAL loreal paris infaillible metallic lip paint 305 cute but psycho COL market VAL 	1
COL name VAL loreal paris paradise siyah maskara COL market VAL 	COL name VAL loreal paris loreal paris paradise maskara siyah maskara COL market VAL 	0
COL name VAL loreal paris unbelieva brow uzun sure kalici kas jeli - 108 dark brunette COL market VAL 	COL name VAL loreal paris loreal paris uzun sure kalici kas jeli unbelieva brow - 105 brunette COL market VAL 	0
COL name VAL loreal paris likit mat ruj - rouge signature 116 i explore COL market VAL 	COL name VAL loreal paris rouge signature likit mat ruj - 116 i explore COL market VAL 	1
COL name VAL loreal paris infaillible paint gel crayon eyeliner 11 vava voum violet COL market VAL 	COL name VAL loreal paris infallible gel crayon eyeliner 11 purple COL market VAL 	1
COL name VAL loreal paris rouge signature matte likit ruj 114 represent COL market VAL 	COL name VAL loreal paris rouge signature likit mat ruj 114 i represent COL market VAL 	1
COL name VAL loreal paris dudak kalemi - infaillible lip pencil 105 red fiction COL market VAL 	COL name VAL loreal paris infaillible dudak kalemi 105 red fiction- kirmizi COL market VAL 	1
COL name VAL loreal paris loreal paris true match bakim yapan fondoten 1r rose ivory 30 ml COL market VAL 	COL name VAL loreal paris loreal paris true match bakim yapan fondoten 1r rose ivory  true match kapatici 1n ivory COL market VAL 	0
COL name VAL loreal paris infaillible shaping stick aydinlatici 501 oh my jewels COL market VAL 	COL name VAL loreal paris infaillible shaping stick 501 oh my jewels stick aydinlatici -  COL market VAL 	1
COL name VAL loreal paris rouge signature metallic likit ruj - 204 i voodoo COL market VAL 	COL name VAL loreal paris likit metalik ruj - rouge signature metallic 204 i voodoo COL market VAL 	1
COL name VAL loreal paris loreal paris true match bakim yapan fondoten 2r rose vanilla+true match kapatici 2rc rose vanilla COL market VAL 	COL name VAL loreal paris true match bakim yapan fondoten 2r rose vanilla+true match kapatici 2n vanilla COL market VAL 	0
COL name VAL loreal paris allik - true match le blush no 165 rose bonne mine COL market VAL 	COL name VAL loreal paris true match allik 165 rosy cheeks COL market VAL 	1
COL name VAL loreal paris infaillible automatic jel goz kalemi - kahverengi COL market VAL 	COL name VAL loreal paris loreal infallible automatic eyeliner brown denim COL market VAL 	1
COL name VAL loreal paris eye paint goz fari no 401 rude boy COL market VAL 	COL name VAL loreal botanicals loreal eye paint goz fari no 401 rude boy COL market VAL 	0
COL name VAL loreal paris bambi eye oversized ceylan goz etkili maskara - siyah COL market VAL 	COL name VAL loreal paris loreal paris bambi eye oversized ceylan goz etkili maskara - siyah COL market VAL 	1
COL name VAL loreal paris loreal paris true match bakim yapan fondoten 4n beige COL market VAL 	COL name VAL loreal paris true match bakim yapan fondoten 2r rose COL market VAL 	0
COL name VAL loreal paris les macarons likit mat ruj 826 mademoiselle mango COL market VAL 	COL name VAL loreal paris likit mat ruj - les macarons ultra matte liquid lipstick 826 mademoiselle mango COL market VAL 	1
COL name VAL loreal paris loreal paris true match nude fondoten serum 2-3 light COL market VAL 	COL name VAL loreal paris loreal true match nude serum fondoten light fondoten fircasi COL market VAL 	0
COL name VAL loreal paris bambi oversized eye siyah maskara  ayna COL market VAL 	COL name VAL loreal paris siyah maskara bambi eye oversized black COL market VAL 	0
COL name VAL loreal paris infallible longwear lip liner 105 red fiction COL market VAL 	COL name VAL loreal botanicals loreal paris infallible longwear lip liner 105 red fiction COL market VAL 	0
COL name VAL loreal paris mat eyeliner - matte signature eyeliner 03 marron 30175242 COL market VAL 	COL name VAL loreal paris matte signature eyeliner 03 marron - kahverengi COL market VAL 	1
COL name VAL loreal paris true match bakim yapan fondoten 1n ivory COL market VAL 	COL name VAL loreal paris loreal paris true match bakim yapan fondoten 4n beige COL market VAL 	0
COL name VAL loreal paris lash paradise waterproofsuya dayanikli maskara 64ml COL market VAL 	COL name VAL loreal paris lash paradise waterproof suya dayanikli maskara 64ml COL market VAL 	0
COL name VAL loreal paris ruj caresse 602 irresistible expresso COL market VAL 	COL name VAL loreal paris rouge caresse 602 irresistible expression ruj COL market VAL 	1
COL name VAL loreal paris true match bakim yapan fondoten 4n beige COL market VAL 	COL name VAL loreal paris loreal paris true match bakim yapan fondoten 4n beige COL market VAL 	1
COL name VAL loreal paris ruj - lip paint metallic 306 lolita COL market VAL 	COL name VAL loreal paris ruj lip paint metallic 306 lolita COL market VAL 	1
COL name VAL loreal paris true match pudra 3r3c rose beige COL market VAL 	COL name VAL loreal paris pudra - true match powder 2n vanilla COL market VAL 	1
COL name VAL loreal paris infaillible shaping stick fondoten 140 natural rose COL market VAL 	COL name VAL loreal paris infaillible shaping stick fondoten 140 natural rose COL market VAL 	1
COL name VAL loreal paris cest magic bb krem 02 light COL market VAL 	COL name VAL loreal paris cest magic bb krem 02 light COL market VAL 	1
COL name VAL loreal paris mascara telescopic black_ COL market VAL 	COL name VAL loreal paris loreal paris telescopic mascara maskara COL market VAL 	0
COL name VAL loreal paris infaillible sculpt palette kontur paleti 03 medium dark COL market VAL 	COL name VAL loreal paris kontur paleti - infallible sculpt contouring palette 03 mediumdark COL market VAL 	1
COL name VAL loreal paris ruj - labial color riche caresse lipstick 04 rose mademoiselle COL market VAL 	COL name VAL loreal paris rouge caresse - ruj 04 rose mademoiselle COL market VAL 	1
COL name VAL loreal paris infaillible total cover 24h kamuflaj paleti total cover COL market VAL 	COL name VAL loreal paris kapatici paleti - infaillible totalcover concealer palette COL market VAL 	1
COL name VAL loreal paris kas kiti acik - brow artist genius kit 01 light to medium orta ton COL market VAL 	COL name VAL loreal paris brow artist genius kit 01 light to medium - aciktan ortaya COL market VAL 	1
COL name VAL loreal paris mega volume miss manga black angel maskara COL market VAL 	COL name VAL loreal paris koyu siyah maskara - mega volume miss manga black angel COL market VAL 	1
COL name VAL loreal paris ruj - infallible mega gloss 503 all night long COL market VAL 	COL name VAL loreal paris mega gloss lip gloss 503 all night long COL market VAL 	1
COL name VAL loreal paris infaillible 24h matte cover yuksek kapatici fondoten 90 rose porcelain COL market VAL 	COL name VAL loreal paris infaillible 24h matte cover yuksek kapatici fondoten - 90 rose porcelain COL market VAL 	1
COL name VAL loreal paris lash paradise intense black ekstra siyah maskara COL market VAL 	COL name VAL loreal paris lash paradise intense black ekstra siyah maskara COL market VAL 	1
COL name VAL loreal paris suya dayanikli siyah eyeliner - super liner black lacquer waterproof eyeliner 6 ml COL market VAL 	COL name VAL loreal paris super liner black lacquer waterproof eyeliner COL market VAL 	1
COL name VAL loreal paris infaillible 24h fondoten - 230 radiant honey COL market VAL 	COL name VAL loreal paris infaillible 24h fondoten 230 radiant honey COL market VAL 	1
COL name VAL loreal paris infaillible shaping stick fondoten 160 sand COL market VAL 	COL name VAL loreal paris stick fondoten - infaillible shaping stick fondoten 160 sand COL market VAL 	1
COL name VAL loreal paris brilliant signature plump in gloss ruj 412 i heighten COL market VAL 	COL name VAL loreal paris loreal paris brilliant signature plump in gloss ruj 402 i soar COL market VAL 	0
COL name VAL loreal paris infaillible dudak kalemi 101 gone with the nude- nude COL market VAL 	COL name VAL loreal paris dudak kalemi - infaillible lip pencil 101 gone with the nude COL market VAL 	1
COL name VAL loreal paris ruj - lip paint metallic 306 lolita COL market VAL 	COL name VAL loreal paris infaillible metallic lip paint 306 lolita COL market VAL 	1
COL name VAL loreal paris bb krem - bonjour nudista bb cream 04 medium dark COL market VAL 	COL name VAL loreal paris bonjour nudista aydinlik veren renkli nemlendirici 04 medium dark - koyu ton COL market VAL 	1
COL name VAL loreal paris color riche rock woman mat ruj 901 rebellion COL market VAL 	COL name VAL loreal paris color riche x balmain collection rock woman mat ruj 901 rebellion COL market VAL 	1
COL name VAL loreal paris ruj - infallible mega gloss 407 smoke me up COL market VAL 	COL name VAL loreal paris mega gloss lip gloss 407 smoke me up COL market VAL 	1
COL name VAL loreal paris true match bakim yapan fondoten 2r rose COL market VAL 	COL name VAL loreal paris true match bakim yapan fondoten 1n ivory fondoten COL market VAL 	0
COL name VAL loreal paris loreal paris bambi eye ceylan goz etkili maskara siyah 89 ml COL market VAL 	COL name VAL loreal paris bambi eye ceylan goz etkili siyah maskara COL market VAL 	0
COL name VAL loreal paris paris false lash telescopic fiber maskara COL market VAL 	COL name VAL loreal paris false lash telescopic fiber maskara - siyah COL market VAL 	1
COL name VAL loreal paris mavi eyeliner - infaillible gel crayon eyeliner 10 blue COL market VAL 	COL name VAL loreal paris infaillible gel crayon goz kalemi 10 ive got the blue - mavi COL market VAL 	1
COL name VAL loreal paris loreal color queen tekli goz fari 26 stunner COL market VAL 	COL name VAL loreal paris color queen tekli goz fari 26 stunner COL market VAL 	1
COL name VAL loreal paris true match bakim yapan fondoten 1r rose ivory COL market VAL 	COL name VAL loreal paris loreal paris true match fondoten 1r1c1k ivory rose COL market VAL 	0
COL name VAL loreal paris mavi goz kalemi - contour khol portofino blue COL market VAL 	COL name VAL loreal paris contour khol 108 portofino blue goz kalemi COL market VAL 	1
COL name VAL loreal paris loreal paris infaillible 2-step 24 saat kalici likit ruj  balm - 804 metro-proof rose COL market VAL 	COL name VAL loreal paris loeral infaillable lipstick 2 steps 804-metro proo COL market VAL 	1
COL name VAL loreal paris color riche matte addiction ruj 654 bronze sautoir - kahverengi COL market VAL 	COL name VAL loreal paris mat ruj color riche matte addiction 654 bronze sautoir COL market VAL 	1
COL name VAL loreal paris loreal paris telescopic maskara - siyah 1 paket COL market VAL 	COL name VAL loreal paris telescopic yeni siyah maskara COL market VAL 	0
COL name VAL loreal paris dudak kalemi - infaillible lip pencil 205 apocalypse red COL market VAL 	COL name VAL loreal paris infaillible dudak kalemi 205 apocalypse red- kirmizi COL market VAL 	1
COL name VAL loreal paris ruj - infallible mega gloss 206 for the lady COL market VAL 	COL name VAL loreal paris mega gloss lip gloss 206 for the ladies COL market VAL 	1
COL name VAL loreal paris infaillible eye paint goz fari 101 eternal white COL market VAL 	COL name VAL loreal paris goz fari - infaillible eyeshadow paint 101 eternal white COL market VAL 	1
COL name VAL loreal paris infaillible 24h fresh wear pudra fondoten 140 golden beige COL market VAL 	COL name VAL loreal paris loreal infaillible 24h fresh wear 140 golden beige fondoten sungeri seti COL market VAL 	0
COL name VAL loreal paris likit mat ruj - infallible lip paint lacquer 105 red fiction COL market VAL 	COL name VAL loreal paris infaillible lip paint likit ruj lacquer 105 red fiction COL market VAL 	1
COL name VAL loreal paris ruj - color riche free the nudes 04 no cage COL market VAL 	COL name VAL loreal paris color riche free the nudes ruj - no pressure COL market VAL 	0
COL name VAL loreal paris allik - true match le blush no 95 rose in love COL market VAL 	COL name VAL loreal paris true match allik 95 rose in love COL market VAL 	1
COL name VAL loreal paris ruj - labial color riche caresse lipstick 203 rockn mauve COL market VAL 	COL name VAL loreal paris rouge caresse 203 rocknmauve ruj COL market VAL 	1
COL name VAL loreal paris loreal paris true match bakim yapan fondoten 5d golden sand COL market VAL 	COL name VAL loreal paris true match bakim yapan fondoten 6d golden honey COL market VAL 	0
COL name VAL loreal paris loreal paris true match bakim yapan fondoten 4n beige COL market VAL 	COL name VAL loreal paris true match bakim yapan fondoten 5r5c5k COL market VAL 	0
COL name VAL loreal paris true match nude serum fondoten 2-3 light COL market VAL 	COL name VAL loreal paris loreal paris true match nude fondoten serum 2-3 light COL market VAL 	1
COL name VAL loreal paris extraordinaire 401 fuschia drama COL market VAL 	COL name VAL loreal paris likit ruj - color riche lextraordinaire lipstick 401 fuchia drama COL market VAL 	1
COL name VAL loreal paris siyah  paradise maskara COL market VAL 	COL name VAL loreal paris paradise siyah maskara COL market VAL 	1
COL name VAL loreal paris infaillible 24h matte cover yuksek kapatici fondoten - 155 natural rose COL market VAL 	COL name VAL loreal paris infaillible 24h matte cover yuksek kapatici fondoten 155 natural rose COL market VAL 	1
COL name VAL loreal paris loreal paris color riche free the nudes ruj - no cliche COL market VAL 	COL name VAL loreal paris ruj - color riche free the nudes 08 no lies COL market VAL 	0
COL name VAL loreal paris color riche free the nudes ruj - no hesitation COL market VAL 	COL name VAL loreal paris ruj - color riche free the nudes 05 no diktat COL market VAL 	1
COL name VAL loreal paris unlimited siyah maskara COL market VAL 	COL name VAL loreal paris unlimited siyah maskara COL market VAL 	1
COL name VAL loreal paris caresse lipstick ruj 202 COL market VAL 	COL name VAL loreal paris ruj - color riche rouge caresse lipstick 202 impulsive fuschia COL market VAL 	1
COL name VAL loreal paris infaillible 24h matte cover yuksek kapatici fondoten 260 golden sun COL market VAL 	COL name VAL loreal paris infaillible 24h matte cover yuksek kapatici fondoten - 260 golden sun COL market VAL 	1
COL name VAL loreal paris uc etkili micellar makyaj temizleme suyu normal - karma ciltler 200 ml COL market VAL 	COL name VAL loreal botanicals loreal paris uc etkili micellar makyaj temizleme suyu normal - karma ciltler 200 ml COL market VAL 	0
COL name VAL loreal paris bronze please bronzlastirici pudra 04 taormina intenso COL market VAL 	COL name VAL loreal paris bronzlastirici pudra - bronze please taormina intenso 04 COL market VAL 	1
COL name VAL loreal paris true match bakim yapan fondoten 1r rose ivory COL market VAL 	COL name VAL loreal paris true match bakim yapan fondoten 1n ivory COL market VAL 	0
COL name VAL loreal paris color queen tekli goz fari 17 COL market VAL 	COL name VAL loreal paris tekli goz fari - color queen mono eyeshadow 17 dont stop me 30173156 COL market VAL 	1
COL name VAL loreal paris infallible super grip primer COL market VAL 	COL name VAL loreal paris infaillible super grip guclu tutus saglayan makyaj bazi COL market VAL 	1
COL name VAL loreal paris infaillible more than concealer 323 fawn tum yuze uygulanabilir kapatici COL market VAL 	COL name VAL loreal paris infaillible tum yuze uygulanabilir kapatici 323 fawn COL market VAL 	1
COL name VAL loreal paris dudak kalemi - infaillible lip pencil 06 golden woman COL market VAL 	COL name VAL loreal paris infallible waterproof gel crayon eyeliner 06 golden woman COL market VAL 	1
COL name VAL loreal paris loreal infallible automatic eyeliner brown denim COL market VAL 	COL name VAL loreal paris infaillible automatic jel goz kalemi - kahverengi COL market VAL 	1
COL name VAL loreal paris superliner black lacquer waterproof eyeliner - siyah COL market VAL 	COL name VAL loreal paris super liner black lacquer waterproof eyeliner COL market VAL 	1
COL name VAL loreal paris true match pudra c3 rose beige COL market VAL 	COL name VAL loreal paris pudra - true match powder 2n vanilla COL market VAL 	1
COL name VAL loreal paris ruj - lip paint metallic 306 lolita COL market VAL 	COL name VAL loreal paris ruj - lip paint metallic 306 lolita COL market VAL 	1
COL name VAL loreal paris waterproof crayon eyeliner 07 silver06 gold COL market VAL 	COL name VAL loreal paris paris waterproof crayon eyeliner 07 silver COL market VAL 	0
COL name VAL loreal paris mat gri superliner - superliner mat matic 03 taupe grey COL market VAL 	COL name VAL loreal paris super liner gelmatic 03 taupe grey - gri goz kalemi COL market VAL 	1
COL name VAL loreal paris loreal paris uzun sure kalici kas jeli unbelieva brow - 108 dark brunette COL market VAL 	COL name VAL loreal paris unbelieva brow uzun sure kalici kas jeli - 108 dark brunette COL market VAL 	0
COL name VAL loreal paris infaillible 24h matte cover yuksek kapatici fondoten - 90 rose porcelain COL market VAL 	COL name VAL loreal paris infaillible 24h matte cover yuksek kapatici fondoten 90 rose porcelain COL market VAL 	1
COL name VAL loreal paris les chocolats likit mat ruj 862 volupto choco COL market VAL 	COL name VAL loreal paris les chocolats likit mat ruj 862 volupto choco COL market VAL 	1
COL name VAL loreal paris infaillible 24h matte cover yuksek kapatici fondoten 130 true beige COL market VAL 	COL name VAL loreal paris infaillible 24h matte cover yuksek kapatici fondoten - 130 true beige COL market VAL 	1
COL name VAL loreal paris infaillible tum yuze uygulanabilir kapatici 322 ivory COL market VAL 	COL name VAL loreal paris loreal paris infaillible 24h tum yuze uygulanabilir kapatici - 326 vanilla COL market VAL 	0
COL name VAL loreal paris loreal paris telescopic carbon siyah maskara maskara COL market VAL 	COL name VAL loreal paris telescopic siyah maskara 2li set COL market VAL 	0
COL name VAL loreal paris no 140 true mach allik COL market VAL 	COL name VAL loreal paris true match blush 140 v COL market VAL 	1
COL name VAL loreal paris loreal paris true match bakim yapan fondoten 4n beige COL market VAL 	COL name VAL loreal paris true match bakim yapan fondoten 4n beige COL market VAL 	0
COL name VAL loreal paris loreal paris bambi eye extra black ceylan goz etkili maskara - ekstra siyah COL market VAL 	COL name VAL loreal paris bambi eye extra black ceylan goz etkili maskara ekstra siyah 30178564 COL market VAL 	0
COL name VAL loreal paris true match foundation 2n vanilla fondoten COL market VAL 	COL name VAL loreal paris true match fondoten 2n vanilla COL market VAL 	0
COL name VAL loreal paris infaillible 24h matte fondoten 24 beige dore COL market VAL 	COL name VAL loreal paris infaillible 24h matte fondoten 24 beige dore COL market VAL 	1
COL name VAL loreal paris loreal paris true match bakim yapan fondoten 5r rose sand COL market VAL 	COL name VAL loreal paris true match bakim yapan fondoten 1r rose ivory COL market VAL 	0
COL name VAL loreal paris paradise orman meyvesi kokulu mor maskara 02 COL market VAL 	COL name VAL loreal paris paradise orman meyvesi kokulu mor maskara COL market VAL 	1
COL name VAL loreal paris true match bakim yapan fondoten 6d golden honey COL market VAL 	COL name VAL loreal paris loreal paris true match bakim yapan fondoten 5d golden sand COL market VAL 	0
COL name VAL loreal paris superliner smokissime eyeliner COL market VAL 	COL name VAL loreal paris superliner smokissime eyeliner black COL market VAL 	1
COL name VAL loreal paris loreal paris uzun sure kalici kas jeli unbelieva brow - 105 brunette COL market VAL 	COL name VAL loreal paris unbelieva brow uzun sure kalici kas jeli -105 brunette COL market VAL 	1
COL name VAL loreal paris infaillible tum yuze uygulanabilir kapatici 338 honey COL market VAL 	COL name VAL loreal paris infaillible tum yuze uygulanabilir kapatici 322 ivory COL market VAL 	0
COL name VAL loreal paris infaillible 24 fresh wear fondoten 140 beige doregolden beige 30ml COL market VAL 	COL name VAL loreal paris infaillible 24h fresh wear pudra fondoten 140 golden beige COL market VAL 	0
COL name VAL loreal infallible longwear shaping stick 501 COL market VAL 	COL name VAL loreal botanicals loreal infallible longwear shaping stick 503 COL market VAL 	0
COL name VAL loreal paris true match bakim yapan fondoten 4n beige COL market VAL 	COL name VAL loreal paris true match bakim yapan fondoten 45n true beige COL market VAL 	0
COL name VAL loreal paris loreal paris hacim veren maskara - siyah COL market VAL 	COL name VAL loreal paris air volume mega hacim veren maskara - siyah COL market VAL 	0
COL name VAL loreal paris rouge signature empowereds likit mat ruj - 136 armored COL market VAL 	COL name VAL loreal paris rouge signature empowereds likit mat ruj 136 armored COL market VAL 	1
COL name VAL loreal paris brow artist high contour 109 ebony kas kalemi - COL market VAL 	COL name VAL loreal paris brow artist high contour 109 ebony - esmer COL market VAL 	1
COL name VAL loreal paris color riche ruj no125 maison marais COL market VAL 	COL name VAL loreal paris loreal color riche lipstick 125 COL market VAL 	1
COL name VAL loreal paris les macarons ultra matte likit ruj 826 mademoise COL market VAL 	COL name VAL loreal paris likit mat ruj - les macarons ultra matte liquid lipstick 826 mademoiselle mango COL market VAL 	1
COL name VAL loreal paris kadin 163 orange magique ruj COL market VAL 	COL name VAL loreal paris color riche saten bitisliruj 163 orange magique - turuncu COL market VAL 	1
COL name VAL loreal paris likit mat ruj - les macarons ultra matte liquid lipstick 834 infinite spice COL market VAL 	COL name VAL loreal paris ral infmacaronsnu ruj 834 infinite sp COL market VAL 	1
COL name VAL loreal paris-micellar makyaj temizleme suyu normalden ve karmaya hassas ciltler icin 200 ml COL market VAL 	COL name VAL loreal paris micellar makyaj temizleme suyu normalden ve karmaya hassas ciltler icin 200 ml COL market VAL 	0
COL name VAL loreal paris true match kapatici 3n creamy beige COL market VAL 	COL name VAL loreal paris true match kapatici 3n creamy beige kapatici COL market VAL 	0
COL name VAL loreal paris infaillible 24h matte cover yuksek kapatici fondoten - 175 sablesand COL market VAL 	COL name VAL loreal paris infaillible 24h matte cover yuksek kapatici fondoten 175 sablesand COL market VAL 	1
COL name VAL loreal paris color riche intense volume matte ruj - 346 rouge determination COL market VAL 	COL name VAL loreal paris color riche intense volume matte ruj - 346 rouge determination COL market VAL 	1
COL name VAL loreal paris color riche plump  shine ruj 109 blue mint plump COL market VAL 	COL name VAL loreal paris color riche plump  shine ruj 109 blue mint plump COL market VAL 	1
COL name VAL loreal paris color riche plump  shine ruj 106 pitaya plump COL market VAL 	COL name VAL loreal paris kadin pembe dolgunlastirici mat ruj 106 COL market VAL 	1
COL name VAL loreal paris ruj - color riche privee nudes - juliannes nude COL market VAL 	COL name VAL loreal paris color riche collection privee juliannes nude ruj COL market VAL 	1
COL name VAL loreal paris infaillible paint gel crayon eyeliner 08 rest in kaki COL market VAL 	COL name VAL loreal paris yesil eyeliner - infaillible gel crayon eyeliner 08 kaki COL market VAL 	1
COL name VAL loreal paris color riche x balmain collection rock woman mat ruj 902 legend COL market VAL 	COL name VAL loreal paris color riche x balmain ruj 902 legend- kahverengi COL market VAL 	1
COL name VAL loreal paris true match bakim yapan fondoten 2r rose vanilla COL market VAL 	COL name VAL loreal paris fondoten - true match no2r2c vanilla rose COL market VAL 	1
COL name VAL loreal paris ruj - color riche rouge caresse lipstick 202 impulsive fuschia COL market VAL 	COL name VAL loreal paris caresse lipstick ruj 202 COL market VAL 	1
COL name VAL loreal paris color riche intense volume matte ruj - 103 blush audace COL market VAL 	COL name VAL loreal paris color riche intense volume matte ruj - 103 blush audace COL market VAL 	1
COL name VAL loreal paris rouge signature likit mat ruj - 113 i dont COL market VAL 	COL name VAL loreal paris rouge signature likit mat ruj - 113 i dont COL market VAL 	1
COL name VAL loreal paris loreal paris bambi eye ceylan goz etkili maskara siyah 89 ml COL market VAL 	COL name VAL loreal paris loreal paris bambi eye oversized ceylan goz etkili maskara - siyah COL market VAL 	0
COL name VAL loreal paris brow artist high contour 107 cool brunette - koyu kumral COL market VAL 	COL name VAL loreal paris kas kalemi - brow artist high contour 107 cool brown COL market VAL 	1
COL name VAL loreal paris allik paleti - infallible blush palette 01 pink COL market VAL 	COL name VAL loreal paris infaillible blush paint palette 01 pinks COL market VAL 	1
COL name VAL loreal paris color riche plump  shine ruj COL market VAL 	COL name VAL loreal paris color riche plump  shine ruj 107 coconut plump COL market VAL 	1
COL name VAL loreal paris superliner black lacquer waterproof eyeliner - siyah COL market VAL 	COL name VAL loreal paris siyah superliner black lacquer waterproof eyeliner COL market VAL 	0
COL name VAL loreal paris likit mat ruj - rouge signature 105 rule COL market VAL 	COL name VAL loreal paris rouge signature likit mat ruj 105 rule COL market VAL 	1
COL name VAL loreal paris mavi  infaillible gel crayon eyeliner 10 blue COL market VAL 	COL name VAL loreal paris infaillible gel crayon 24h eyeliner 10 blue COL market VAL 	1
COL name VAL loreal paris true match bakim yapan fondoten 2n vanilla COL market VAL 	COL name VAL loreal paris true match bakim yapan fondoten 2r rose vanilla COL market VAL 	0
COL name VAL loreal paris superliner black lacquer waterproof eyeliner - siyah COL market VAL 	COL name VAL loreal paris suya dayanikli siyah eyeliner - super liner black lacquer waterproof eyeliner 6 ml COL market VAL 	1
COL name VAL loreal paris infaillible eye paint goz fari 204 infinite blue COL market VAL 	COL name VAL loreal paris goz fari - infallible eyeshadow paint 204 infinite blue COL market VAL 	1
COL name VAL loreal paris telescopic carbon black maskara - siyah maskara COL market VAL 	COL name VAL loreal paris telescopic carbon black maskara - siyah COL market VAL 	1
COL name VAL loreal paris true match bakim yapan fondoten 1r rose ivory 30 ml COL market VAL 	COL name VAL loreal paris true match bakim yapan fondoten 1r rose ivory COL market VAL 	0
COL name VAL loreal paris color riche intense volume matte ruj - 602 nude admirable COL market VAL 	COL name VAL loreal paris color riche intense volume matte ruj - 602 nude admirable  ayna COL market VAL 	0
COL name VAL loreal paris ruj - color riche lipstick 134 pink panac COL market VAL 	COL name VAL loreal paris color riche ruj 134 pink panac COL market VAL 	1
COL name VAL loreal paris uzun sure kalici fondoten - infallible 24h foundation 150 beige 30 ml COL market VAL 	COL name VAL loreal paris infaillible 24h fondoten 150 radiant eclat COL market VAL 	1
COL name VAL loreal paris loreal paris true match bakim yapan fondoten 5r rose sand COL market VAL 	COL name VAL loreal paris true match bakim yapan fondoten 5n sand COL market VAL 	0
COL name VAL loreal paris true match bakim yapan fondoten 5r rose sand COL market VAL 	COL name VAL loreal paris loreal paris true match bakim yapan fondoten 7r rose amber COL market VAL 	0
COL name VAL loreal paris color riche ruj 630 beige a nu COL market VAL 	COL name VAL loreal paris ruj - color riche lipstick 630 beige a nu COL market VAL 	1
COL name VAL loreal paris dudak kalemi - infaillible lip pencil 701 stay ultraviolet COL market VAL 	COL name VAL loreal paris infallible stay ultraviolet 701 dudak kalemi COL market VAL 	0
COL name VAL loreal paris pudra - true match powder 2n vanilla COL market VAL 	COL name VAL loreal paris true match pudra 3r3c rose beige COL market VAL 	1
COL name VAL loreal botanicals loreal paris infallible longwear lip liner 207 wathering purple COL market VAL 	COL name VAL loreal paris infallible longwear lip liner 207 wathering purple COL market VAL 	0
COL name VAL loreal paris loreal paris true match bakim yapan fondoten 15 linen COL market VAL 	COL name VAL loreal paris true match bakim yapan fondoten 4n beige COL market VAL 	0
COL name VAL loreal paris bambi oversized eye maskara - siyah COL market VAL 	COL name VAL loreal paris loreal paris bambi eye oversized ceylan goz etkili maskara - siyah COL market VAL 	1
COL name VAL loreal paris air volume mega maskara COL market VAL 	COL name VAL loreal paris loreal paris mega air volume siyah maskara 58 ml maskara COL market VAL 	0
COL name VAL loreal paris waterproof crayon eyeliner 07 silver06 gold COL market VAL 	COL name VAL loreal paris paris waterproof crayon eyeliner 06 golden COL market VAL 	0
COL name VAL loreal paris lash paradise intense black ekstra siyah maskara COL market VAL 	COL name VAL loreal paris loreal paris lash paradise intense black ekstra siyah maskara COL market VAL 	0
COL name VAL loreal paris-micellar makyaj temizleme suyu normalden ve karmaya hassas ciltler icin 200 ml COL market VAL 	COL name VAL loreal paris micellar makyaj temizleme suyu normalden ve kuruya hassas ciltler icin 200 ml COL market VAL 	0
COL name VAL loreal paris false lash telescopic fiber siyah maskara -3600522097303 COL market VAL 	COL name VAL loreal paris false lash telescopic fiber maskara - siyah COL market VAL 	1
COL name VAL loreal paris mega volume collagene 24h siyah maskara COL market VAL 	COL name VAL loreal paris loreal paris mega volume collagene 24h siyah maskara maskara COL market VAL 	0
COL name VAL loreal paris likit mat ruj - les chocolats ultra matte liquid lipstick 848 dose of cocoa COL market VAL 	COL name VAL loreal paris les chocolats likit mat ruj 848 dose of cocoa COL market VAL 	1
COL name VAL loreal paris true match bakim yapan fondoten 3r rose beige COL market VAL 	COL name VAL loreal paris loreal paris true match bakim yapan fondoten 7r rose amber COL market VAL 	0
COL name VAL loreal paris true match bakim yapan fondoten 1d golden ivory COL market VAL 	COL name VAL loreal paris true match bakim yapan fondoten - 1d golden ivory COL market VAL 	1
COL name VAL loreal paris pudra - true match powder 2n vanilla COL market VAL 	COL name VAL loreal paris true match pudra c3 rose beige COL market VAL 	1
COL name VAL loreal paris bambi eye oversized ceylan goz etkili maskara - siyah COL market VAL 	COL name VAL loreal paris bambi eye ceylan goz etkili maskara  siyah COL market VAL 	0
COL name VAL loreal paris infaillible 24h fondoten 130 true beige COL market VAL 	COL name VAL loreal paris infaillible 24h fondoten 130 true beige COL market VAL 	1
COL name VAL loreal paris lash paradise intense black ekstra siyah maskara COL market VAL 	COL name VAL loreal paris loreal paris lash paradise intense black ekstra siyah maskara 2li set 1 paket 1 x 2 adet COL market VAL 	0
COL name VAL loreal paris likit mat ruj - infaillible lip paint matte 201 hollywood beige COL market VAL 	COL name VAL loreal paris infaillible lip paint likit ruj matte 201 hollywood beige- nude COL market VAL 	1
COL name VAL loreal paris color queen tekli goz fari 10 flaming COL market VAL 	COL name VAL loreal paris tekli goz fari - color queen mono eyeshadow 10 flaming 30173088 COL market VAL 	1
COL name VAL loreal paris true match bakim yapan fondoten 1n ivory fondoten COL market VAL 	COL name VAL loreal paris loreal paris true match bakim yapan fondoten 1r rose ivory  true match kapatici 1n ivory COL market VAL 	0
COL name VAL loreal paris les chocolats likit mat ruj 842 candy man COL market VAL 	COL name VAL loreal paris les chocolats ultra matte likit ruj 842 candy man COL market VAL 	1
COL name VAL loreal paris rouge signature empowereds likit mat ruj 141 discovered COL market VAL 	COL name VAL loreal paris rouge signature empowereds likit mat ruj - 141 discovered COL market VAL 	1
COL name VAL loreal paris telescopic yeni siyah maskara COL market VAL 	COL name VAL loreal paris loreal paris telescopic carbon siyah maskara maskara COL market VAL 	0
COL name VAL loreal paris fondoten true match foundation 3d golden beige 30 ml COL market VAL 	COL name VAL loreal paris true match bakim yapan fondoten 3d golden beige COL market VAL 	1
COL name VAL loreal paris mega gloss lip gloss 107 whos the boss COL market VAL 	COL name VAL loreal paris ruj - infallible mega gloss 107 whos the boss COL market VAL 	1
COL name VAL loreal paris kas kalemi - brow artist high contour 103 warm blonde COL market VAL 	COL name VAL loreal paris brow artist high contour 103 warm blond - acik sarisin COL market VAL 	1
COL name VAL loreal paris lash architect 4d siyah maskara COL market VAL 	COL name VAL loreal paris siyah maskara - false lash architect 4d mascara black COL market VAL 	1
COL name VAL loreal paris loreal true match nude serum fondoten very light fondoten fircasi seti COL market VAL 	COL name VAL loreal paris true match nude serum fondoten 05-2 very light COL market VAL 	0
COL name VAL loreal paris loreal paris true match bakim yapan fondoten 2r rose vanilla COL market VAL 	COL name VAL loreal paris true match bakim yapan fondoten 2r rose vanilla+true match kapatici 2n vanilla COL market VAL 	0
COL name VAL loreal paris ruj - labial color riche caresse lipstick 03 lovely rose COL market VAL 	COL name VAL loreal paris rouge caresse - ruj 03 lovely rose COL market VAL 	1
COL name VAL loreal paris paris kas kalemiaydinlatici 108 warm brunett COL market VAL 	COL name VAL loreal paris brow artist high contour 105 brunette  kumral COL market VAL 	1
COL name VAL loreal paris loreal fondoten paris infaillible 24h matte cover yuksek kapatici fondoten no 200 golden sand COL market VAL 	COL name VAL loreal paris infaillible 24h matte cover yuksek kapatici fondoten 200 golden sand COL market VAL 	0
COL name VAL loreal paris loreal true match nude serum fondoten very light 360 fondoten fircasi COL market VAL 	COL name VAL loreal paris loreal true match nude serum fondoten very light fondoten fircasi seti COL market VAL 	0
COL name VAL loreal paris les macarons likit mat ruj 834 infinite spice COL market VAL 	COL name VAL loreal paris likit mat ruj - les macarons ultra matte liquid lipstick 834 infinite spice COL market VAL 	1
COL name VAL loreal paris marka loreal paris pembe color riche saten bitisli violet saturne ruj 214 kategori ruj COL market VAL 	COL name VAL loreal paris pembe color riche saten bitisli violet saturne ruj 214 COL market VAL 	0
COL name VAL loreal paris ruj - infallible sexy balm 203 yala yolo COL market VAL 	COL name VAL loreal paris infaillible sexy balm ruj 203 yala yolo COL market VAL 	1
COL name VAL loreal paris dudak kalemi - color riche crayon liner 461 scarlet rouge COL market VAL 	COL name VAL loreal paris color riche dudak kalemi 461 scarlet rouge COL market VAL 	1
COL name VAL loreal paris mat ruj - color riche matte addiction 655 copper clutch COL market VAL 	COL name VAL loreal paris color riche matte addiction ruj 655 copper clutch COL market VAL 	1
COL name VAL loreal paris mat pudra - infaillible 24h ultra matte prestige pudra 225 beige COL market VAL 	COL name VAL loreal paris infaillible 24h ultra matte prestige pudra-225 beige COL market VAL 	1
COL name VAL loreal paris infaillible tum yuze uygulanabilir kapatici 334 walnut COL market VAL 	COL name VAL loreal paris loreal paris infaillible 24h tum yuze uygulanabilir kapatici - 330 pecan COL market VAL 	0
COL name VAL loreal paris loreal true match nude serum fondoten very light fondoten fircasi seti COL market VAL 	COL name VAL loreal paris loreal true match nude serum fondoten very light 360 fondoten fircasi COL market VAL 	0
COL name VAL loreal paris loreal paris true match bakim yapan fondoten 4n beige COL market VAL 	COL name VAL loreal paris loreal paris true match bakim yapan fondoten 4n beige COL market VAL 	0
COL name VAL loreal paris superstar xfiber siyah maskara COL market VAL 	COL name VAL loreal paris siyah false lash superstar x fiber maskara 01  COL market VAL 	1
COL name VAL loreal paris true match bakim yapan fondoten 6n honey COL market VAL 	COL name VAL loreal paris true match foundation 6n honey 30 ml fondoten - COL market VAL 	1
COL name VAL loreal paris le liner signature goz kalemi 03 rouge noir angora COL market VAL 	COL name VAL loreal paris le liner signature  rouge noir angora goz kalemi 03 30176461 COL market VAL 	1
COL name VAL loreal paris infaillible tum yuze uygulanabilir kapatici 330 pecan COL market VAL 	COL name VAL loreal paris infaillible tum yuze uygulanabilir kapatici 322 ivory COL market VAL 	0
COL name VAL loreal paris cest magic bb krem 05 medium dark COL market VAL 	COL name VAL loreal paris cest magic bb krem 05 medium dark COL market VAL 	0
COL name VAL loreal paris rouge signature parisian sunset likit mat ruj - 127 i revolutionize COL market VAL 	COL name VAL loreal paris rouge signature parisian sunset likit mat ruj 127revolutionize COL market VAL 	1
COL name VAL loreal paris ruj - color riche lipstick 130 androgyne COL market VAL 	COL name VAL loreal paris color riche ruj matte 130 androgyne COL market VAL 	1
COL name VAL loreal paris loreal paris lash paradise intense black ekstra siyah maskara 1 paket 1 x 23 g COL market VAL 	COL name VAL loreal paris lash paradise intense black ekstra siyah maskara COL market VAL 	0
COL name VAL loreal paris color riche x balmain collection rock woman mat ruj 901 rebellion COL market VAL 	COL name VAL loreal paris color riche rock woman mat ruj 901 rebellion COL market VAL 	1
COL name VAL loreal paris loreal paris mascara telescopic black COL market VAL 	COL name VAL loreal paris loreal paris telescopic mascara maskara COL market VAL 	0
COL name VAL loreal paris mat eyeliner - matte signature eyeliner 04 emeraude 30175259 COL market VAL 	COL name VAL loreal paris matte signature eyeliner 04 emeraude - yesil COL market VAL 	1
COL name VAL loreal paris ruj - infallible sexy balm 111 go pretty or go home COL market VAL 	COL name VAL loreal paris infaillible sexy balm ruj 111 go pretty or go home COL market VAL 	1
COL name VAL loreal paris true match bakim yapan fondoten 7r rose amber COL market VAL 	COL name VAL loreal paris loreal paris true match bakim yapan fondoten 7r rose amber COL market VAL 	1
COL name VAL loreal paris loreal paris loreal paris air volume waterproof suya dayanikli maskara maskara COL market VAL 	COL name VAL loreal paris loreal paris air volume mega easy waterproof suya dayanikli maskara - siyah COL market VAL 	0
COL name VAL loreal paris infaillible dudak kalemi 207 wuthering purple x2 COL market VAL 	COL name VAL loreal paris infaillible dudak kalemi 207 wuthering purple- murdum COL market VAL 	0
COL name VAL loreal paris paradise makyaj seti COL market VAL 	COL name VAL loreal paris paradise makyaj seti COL market VAL 	1
COL name VAL loreal paris true match bakim yapan fondoten 4n beige COL market VAL 	COL name VAL loreal paris true match bakim yapan fondoten 45n true beige COL market VAL 	0
COL name VAL loreal paris rouge signature likit mat ruj - 113 i dont COL market VAL 	COL name VAL loreal paris likit mat ruj - rouge signature 113 i dont COL market VAL 	1
COL name VAL loreal paris cest magic bb krem 02 light COL market VAL 	COL name VAL loreal paris cest magic bb krem 02 light COL market VAL 	1
COL name VAL loreal paris goz fari paleti - la petite palette feminist COL market VAL 	COL name VAL loreal paris la petite far paleti - feminist COL market VAL 	1
COL name VAL loreal paris true match bakim yapan fondoten 2d golden almond COL market VAL 	COL name VAL loreal paris true match bakim yapan fondoten 2d golden almond COL market VAL 	1
COL name VAL loreal paris cift tarafli siyah maskara - superstar xfiber xtreme resist mascara COL market VAL 	COL name VAL loreal paris superstar xfiber xtreme resist suya dayanikli siyah maskara COL market VAL 	1
COL name VAL loreal paris loreal paris infaillible 24h tum yuze uygulanabilir kapatici - 330 pecan COL market VAL 	COL name VAL loreal paris infaillible tum yuze uygulanabilir kapatici 334 walnut COL market VAL 	0
COL name VAL loreal paris infaillible 24h ruj 506 red infaillible COL market VAL 	COL name VAL loreal paris infaillible 24h ruj 506 red - kirmizi COL market VAL 	0
COL name VAL loreal paris fondoten - true match no2r2c vanilla rose COL market VAL 	COL name VAL loreal paris true match bakim yapan fondoten 2r rose vanilla COL market VAL 	1
COL name VAL loreal paris true match bakim yapan fondoten 4n beige COL market VAL 	COL name VAL loreal paris true match bakim yapan fondoten 1n ivory fondoten COL market VAL 	0
COL name VAL loreal paris infaillible tum yuze uygulanabilir kapatici 330 pecan COL market VAL 	COL name VAL loreal paris loreal paris infaillible tum yuze uygulanabilir kapatici 338 honey COL market VAL 	0
COL name VAL loreal paris cift fazli micellar kusursuz makyaj temizleme suyu 400 ml COL market VAL 	COL name VAL loreal paris cift fazli micellar kusursuz makyaj temizleme suyu COL market VAL 	1
COL name VAL loreal paris les chocolats ultra matte liquid lipstick 856 yum COL market VAL 	COL name VAL loreal paris les chocolats likit mat ruj 856 70 yum COL market VAL 	1
COL name VAL loreal paris brow artist plump  set dolgun gorunum veren kas sa COL market VAL 	COL name VAL loreal paris brow artist plumpset renkli kas sabitleyici maskara - 108 dark brunette COL market VAL 	1
COL name VAL loreal paris infaillible 24h fondoten 145 rose beige COL market VAL 	COL name VAL loreal paris loreal paris infaillible 32h fresh wear c vitaminli fondoten - 145 rose beige COL market VAL 	1
COL name VAL loreal paris ruj - color riche lipstick 430 mon jules COL market VAL 	COL name VAL loreal paris color riche ruj matte 430 mon jules COL market VAL 	1
COL name VAL loreal paris goz fari paleti - la petite palette optimist COL market VAL 	COL name VAL loreal paris la petite far paleti - optimist COL market VAL 	1
COL name VAL loreal paris infaillible dudak kalemi 205 apocalypse red- kirmizi COL market VAL 	COL name VAL loreal paris dudak kalemi - infaillible lip pencil 205 apocalypse red COL market VAL 	1
COL name VAL loreal paris color richa ultra matte mat ruj no doubts COL market VAL 	COL name VAL loreal paris color riche free the nudes ruj - no hesitation COL market VAL 	1
COL name VAL loreal paris paris stick fondoten 190 beige dore COL market VAL 	COL name VAL loreal paris infaillible shaping stick fondoten 190 beige dore COL market VAL 	1
COL name VAL loreal expert loreal paris mega volume collagene 24h siyah maskara COL market VAL 	COL name VAL loreal paris mega volume collagene 24h siyah maskara COL market VAL 	0
COL name VAL loreal paris loreal paris paradise maskara siyah maskara COL market VAL 	COL name VAL loreal paris loreal paris lash paradise siyah maskara COL market VAL 	0
COL name VAL loreal paris true match bakim yapan fondoten 1n ivory COL market VAL 	COL name VAL loreal paris loreal paris true match bakim yapan fondoten 4n beige COL market VAL 	0
COL name VAL loreal paris true match bakim yapan fondoten 2r rose COL market VAL 	COL name VAL loreal paris true match bakim yapan fondoten 5n sand fondoten COL market VAL 	0
COL name VAL loreal paris mardinal loreal paris visible lift serum inside mat 100 COL market VAL 	COL name VAL loreal paris visible lift serum inside mat 100 COL market VAL 	0
COL name VAL loreal paris kapatici - true match concealer 02 vanilla COL market VAL 	COL name VAL loreal paris true match kapatici 02 vanilla COL market VAL 	1
COL name VAL loreal paris color riche free the nudes ruj - no diktat COL market VAL 	COL name VAL loreal paris ruj - color riche free the nudes 06 no hesitation COL market VAL 	1
COL name VAL loreal paris eyeliner - superliner smokissime 102 brown smoke COL market VAL 	COL name VAL loreal paris superliner smokissime eyeliner brown COL market VAL 	1
COL name VAL loreal paris infaillible 24h matte fondoten 30 miel honey COL market VAL 	COL name VAL loreal paris infaillible 24h matte 30 honey 35 ml mat fondoten -3600522875413 COL market VAL 	1
COL name VAL loreal paris likit mat ruj - infallible lip paint nude paint matte 210 dead lips COL market VAL 	COL name VAL loreal paris infallible lip paint matte ruj no 210 - dead lips COL market VAL 	1
COL name VAL loreal paris infaillible shaping stick fondoten 140 natural rose COL market VAL 	COL name VAL loreal paris infaillible shaping stick fondoten 140 natural rose COL market VAL 	1
COL name VAL loreal paris emotions of nu allik amp far paleti COL market VAL 	COL name VAL loreal paris emotions of nu allik  far paleti COL market VAL 	1
COL name VAL loreal paris loreal paris rouge signature empowereds likit mat ruj - 140 desired COL market VAL 	COL name VAL loreal paris rouge signature empowereds likit mat ruj - 140 desired COL market VAL 	1
COL name VAL loreal paris bronze please bronzlastirici pudra 03 amalfi medio COL market VAL 	COL name VAL loreal paris bronze please bronzlastirici pudra 03 amalfi COL market VAL 	1
COL name VAL loreal paris loreal paris true match bakim yapan fondoten 4n beige COL market VAL 	COL name VAL loreal paris true match bakim yapan fondoten 15 linen COL market VAL 	0
COL name VAL loreal paris true match bakim yapan fondoten 1r rose ivory COL market VAL 	COL name VAL loreal paris true match bakim yapan fondoten 1r rose ivory COL market VAL 	0
COL name VAL loreal paris infaillible tum yuze uygulanabilir kapatici 323 fawn COL market VAL 	COL name VAL loreal paris loreal paris infaillible 24h tum yuze uygulanabilir kapatici - 330 pecan COL market VAL 	0
COL name VAL loreal paris bb krem - bonjour nudista bb cream 04 medium dark COL market VAL 	COL name VAL loreal paris bb krem - bonjour nudista bb cream 04 medium dark COL market VAL 	1
COL name VAL loreal paris le khol  immaculate snow goz kalemi 120 COL market VAL 	COL name VAL loreal paris contour khol goz kalemi 120 immaculate snow COL market VAL 	1
COL name VAL loreal paris infaillible 2-step 24 saat kalici likit ruj  balm - 506 red infaillible COL market VAL 	COL name VAL loreal paris infaillible 24h ruj 506 red infaillible COL market VAL 	1
COL name VAL loreal paris likit mat ruj - les macarons ultra matte liquid lipstick 820 praline de COL market VAL 	COL name VAL loreal paris les macarons ultra matte liquid lipstick ruj 820 pral COL market VAL 	1
COL name VAL loreal paris likit mat ruj - infallible lip paint matte 203 tangerine vertigo COL market VAL 	COL name VAL loreal paris infaillible lip paint likit ruj matte 203 tangerine vertigo COL market VAL 	1
COL name VAL loreal paris true match bakim yapan fondoten 5r rose sand COL market VAL 	COL name VAL loreal paris fondoten - true match foundation 5r rose sand 30 ml COL market VAL 	1
COL name VAL loreal paris true match kapatici 2n vanilla COL market VAL 	COL name VAL loreal paris kapatici - true match concealer 2n vanilla COL market VAL 	1
COL name VAL loreal paris air mega volume ekstra siyah maskara - 30 saate kadar kalici  ayna COL market VAL 	COL name VAL loreal paris air mega volume maskara - 30 saate kadar kalici - ekstra siyah COL market VAL 	0
COL name VAL loreal paris dudak kalemi - infaillible lip pencil 201 hollywood beige COL market VAL 	COL name VAL loreal paris infaillible dudak kalemi 201 hollywood beige- nude COL market VAL 	1
COL name VAL loreal paris loreal paris paradise siyah maskara  brow artist paradise kas pomadi 104 brunette-kumral COL market VAL 	COL name VAL loreal paris brow artist paradise kas pomadi 104 brunette - kumral COL market VAL 	0
COL name VAL loreal paris contour khol goz kalemi 120 immaculate snow COL market VAL 	COL name VAL loreal paris le khol  immaculate snow goz kalemi 120 COL market VAL 	1
COL name VAL loreal paris nude magique cc krem yorgun cilt karsiti anti fatigue COL market VAL 	COL name VAL loreal paris yorgunluk izleri karsiti cc krem - nude magique 30 ml COL market VAL 	1
COL name VAL loreal paris les chocolats likit mat ruj 854 bitter sweet COL market VAL 	COL name VAL loreal paris les chocolats likit mat ruj 854 bitter sweet COL market VAL 	1
COL name VAL loreal paris rouge signature likit mat ruj - 116 i explore COL market VAL 	COL name VAL loreal paris likit mat ruj - rouge signature COL market VAL 	0
COL name VAL loreal paris color riche les nus ruj - 182 nu extreme COL market VAL 	COL name VAL loreal paris color riche les nus ruj 182 nu extreme COL market VAL 	0
COL name VAL loreal paris infaillible 24h fondoten 235 honey COL market VAL 	COL name VAL loreal paris uzun sure kalici fondoten - infallible 24h foundation 235 honey 30 ml COL market VAL 	1
COL name VAL loreal paris infaillible dudak kalemi 212 nude-ist- kahverengi COL market VAL 	COL name VAL loreal paris dudak kalemi - infaillible lip pencil 212 nude-ist COL market VAL 	1
COL name VAL loreal paris true match bakim yapan fondoten 1n ivory fondoten COL market VAL 	COL name VAL loreal paris true match bakim yapan fondoten 45n true beige COL market VAL 	0
COL name VAL loreal paris loreal micellar makyaj temizleyici bambi maskara seti COL market VAL 	COL name VAL loreal paris loreal micellar makyaj temizleyici air volume maskara seti COL market VAL 	0
COL name VAL loreal paris loreal paris color riche shine naked tans ruj 656 beige in the city - nude COL market VAL 	COL name VAL loreal paris color riche shine naked tans ruj 658 topless - nude COL market VAL 	1
COL name VAL loreal paris cest magic bb krem 03 medium light COL market VAL 	COL name VAL loreal paris cest magic bb krem 03 medium light COL market VAL 	1
COL name VAL loreal paris glam shine balmy gloss- 915 COL market VAL 	COL name VAL loreal paris kalem ruj no 915 COL market VAL 	1
COL name VAL loreal paris kas kalemi - brow artist high contour 102 cool blonde COL market VAL 	COL name VAL loreal paris brow artist high contour 102 cool blond - sarisin COL market VAL 	1
COL name VAL loreal paris uzun sure kalici fondoten - infallible 24h foundation 230 golden 30 ml COL market VAL 	COL name VAL loreal paris infaillible 24h fondoten 230 radiant honey COL market VAL 	1
COL name VAL loreal paris superstar xfiber xtreme resist suya dayanikli siyah maskara COL market VAL 	COL name VAL loreal paris cift tarafli siyah maskara - superstar xfiber xtreme resist mascara COL market VAL 	1
COL name VAL loreal paris loreal paris true match bakim yapan fondoten 4n beige COL market VAL 	COL name VAL loreal paris true match bakim yapan fondoten 4n beige COL market VAL 	1
COL name VAL loreal paris true match bakim yapan fondoten 3d golden beige COL market VAL 	COL name VAL loreal paris loreal paris true match bakim yapan fondoten 4n beige COL market VAL 	0
COL name VAL loreal paris infaillible tum yuze uygulanabilir kapatici 323 fawn COL market VAL 	COL name VAL loreal paris infaillible tum yuze uygulanabilir kapatici 322 ivory COL market VAL 	0
COL name VAL loreal paris loreal paris infaillible tum yuze uygulanabilir kapatici 338 honey COL market VAL 	COL name VAL loreal paris infaillible tum yuze uygulanabilir kapatici 332 amber COL market VAL 	0
COL name VAL loreal paris true match bakim yapan fondoten 05n porcelain COL market VAL 	COL name VAL loreal paris true match bakim yapan fondoten 05n porcelain COL market VAL 	1
COL name VAL loreal paris brilliant signature plump in gloss ruj 412 i heighten COL market VAL 	COL name VAL loreal paris brilliant signature plump in gloss ruj seti - 412 i heighten  402 i soar  canta COL market VAL 	0
COL name VAL loreal paris loreal paris true match bakim yapan fondoten 7r rose amber COL market VAL 	COL name VAL loreal paris true match bakim yapan fondoten 1r rose ivory COL market VAL 	0
COL name VAL loreal paris true match bakim yapan fondoten 45n true beige COL market VAL 	COL name VAL loreal paris true match bakim yapan fondoten 45n true beige COL market VAL 	1
COL name VAL loreal paris color riche la vie en rose ruj naomis pink COL market VAL 	COL name VAL loreal paris ruj - color riche privee nudes - naomis pink COL market VAL 	1
COL name VAL loreal paris color riche matte addiction ruj 908 storm - grilila COL market VAL 	COL name VAL loreal paris mat ruj - color riche matTE addiction 908 storm COL market VAL 	1
COL name VAL loreal paris likit ruj - color riche lextraordinaire lipstick 401 fuchia drama COL market VAL 	COL name VAL loreal paris colour riche extraordinaire ruj-101 rose melody COL market VAL 	1
COL name VAL loreal paris likit mat ruj - les chocolats ultra matte liquid lipstick 858 oh my choc COL market VAL 	COL name VAL loreal paris les chocolats ultra matte likit ruj 858 oh my choc COL market VAL 	1
COL name VAL loreal paris ruj - color riche shine addiction lipstick 643 hot irl COL market VAL 	COL name VAL loreal paris color riche shine ruj 643 hot irl - kahverengi COL market VAL 	1
COL name VAL loreal paris ruj lip paint matte 204 red actually COL market VAL 	COL name VAL loreal botanicals loreal paris ruj lip paint matte 204 red actually COL market VAL 	0
COL name VAL loreal paris les chocolats likit mat ruj 860 ginger bomb COL market VAL 	COL name VAL loreal paris kahverengi les chocolats ultra matte liquid lipstick 860 likit mat ruj COL market VAL 	1
COL name VAL loreal paris color riche matte addiction ruj 633 moka chic- nude COL market VAL 	COL name VAL loreal paris mat ruj - color riche matte addiction lipstick 633 moka chic- nude COL market VAL 	1
COL name VAL loreal paris infallible 220 sable sand fondoten COL market VAL 	COL name VAL loreal paris fondoten infallible 220 sable COL market VAL 	1
COL name VAL loreal paris isilti saglayan fondoten - lumi macique foundation dw5 gold sand COL market VAL 	COL name VAL loreal paris lumimagic dw5 spf 18 fondoten COL market VAL 	1
COL name VAL loreal paris color richa ultra matte mat ruj no doubts COL market VAL 	COL name VAL loreal paris ruj - color riche free the nudes 03 no doubts COL market VAL 	1
COL name VAL loreal paris infaillible 24h fondoten - 220 sand COL market VAL 	COL name VAL loreal paris infaillible 24h fondoten 220 sand COL market VAL 	1
COL name VAL loreal paris infaillible 24h fresh wear pudra fondoten 220 sand COL market VAL 	COL name VAL loreal paris infaillible 24h fresh wear pudra fondoten 220 sand COL market VAL 	1
COL name VAL loreal paris true match bakim yapan fondoten 15 linen COL market VAL 	COL name VAL loreal paris loreal paris true match bakim yapan fondoten 4n beige COL market VAL 	0
COL name VAL loreal paris loreal paris color riche shine naked tans ruj 656 beige in the city - nude COL market VAL 	COL name VAL loreal paris color riche shine naked tans ruj 659 blow your glow - nude COL market VAL 	1
COL name VAL loreal paris true match foundation 3n creamy beige fondoten COL market VAL 	COL name VAL loreal paris fondoten - true match foundation 3n creamy beige COL market VAL 	1
COL name VAL loreal paris rouge signature empowereds likit mat ruj 138 honored COL market VAL 	COL name VAL loreal paris rouge signature empowereds likit mat ruj - 138 honored COL market VAL 	1
COL name VAL loreal paris loreal paris true match nude fondoten serum 2-3 light COL market VAL 	COL name VAL loreal paris loreal true match nude serum fondoten light fondoten fircasi COL market VAL 	0
COL name VAL loreal paris normal  karma ve hassas ciltler icin micellar kusursuz makyaj temizleme suyu 400 ml COL market VAL 	COL name VAL loreal paris loreal paris micellar makyaj temizleme suyu normalden kuruya hassas ciltler icin 200 ml COL market VAL 	0
COL name VAL loreal paris bambi eye ceylan goz etkili siyah maskara COL market VAL 	COL name VAL loreal paris bambi eye ceylan goz etkili maskara - siyah COL market VAL 	0
COL name VAL loreal paris loreal paris true match bakim yapan fondoten 7d golden amber COL market VAL 	COL name VAL loreal paris true match bakim yapan fondoten 5d golden sand COL market VAL 	0
COL name VAL loreal paris infaillible 24h ruj 121 flawless fuschia COL market VAL 	COL name VAL loreal paris 24 saat kalici ruj - infallible rouge 121 flawless fuschia COL market VAL 	1
COL name VAL loreal paris infaillible tum yuze uygulanabilir kapatici 326 vanilla COL market VAL 	COL name VAL loreal paris loreal paris infaillible 24h tum yuze uygulanabilir kapatici - 330 pecan COL market VAL 	0
COL name VAL loreal paris volume million lashes so couture noir black maskara 95 ml COL market VAL 	COL name VAL loreal paris volume million lashes so couture noir black maskara 95ml COL market VAL 	0
COL name VAL loreal paris true match bakim yapan fondoten 45n true beige COL market VAL 	COL name VAL loreal paris true match bakim yapan fondoten 5n sand fondoten COL market VAL 	0
COL name VAL loreal paris brow artist plumpset renkli kas sabitleyici maskara - 108 dark brunette COL market VAL 	COL name VAL loreal paris brow artist plump  set dolgun gorunum veren kas sa COL market VAL 	1
COL name VAL loreal paris ruj sexy balm 204 never stop COL market VAL 	COL name VAL loreal paris ruj sexy balm 204 never stop COL market VAL 	0
COL name VAL loreal paris telescopic gold siyah maskara  infaillible 24h fresh wear pudra fondoten 120 vanilla COL market VAL 	COL name VAL loreal paris telescopic gold siyah maskara  infaillible 24h fresh wear pudra fondoten 120 vanilla COL market VAL 	0
COL name VAL loreal paris loreal paris true match bakim yapan fondoten 15 linen COL market VAL 	COL name VAL loreal paris true match bakim yapan fondoten 5n sand COL market VAL 	0
COL name VAL loreal paris les macarons likit mat ruj 832 strawberry sauvage COL market VAL 	COL name VAL loreal paris likit mat ruj - les macarons ultra matte liquid lipstick 832 strawberry sauvage COL market VAL 	1
COL name VAL loreal paris infaillible 24h matte cover yuksek kapatici fondoten - 260 golden sun COL market VAL 	COL name VAL loreal paris infaillible 24h matte cover yuksek kapatici fondoten 115 golden beige COL market VAL 	0
COL name VAL loreal paris matte lip crayon no 113 brulee everday kalem mat ruj COL market VAL 	COL name VAL loreal paris infaillible matte lip crayon kalem mat ruj - 113 brulee everyday COL market VAL 	1
COL name VAL loreal  paris true match bakim yapan fondoten 4n beige COL market VAL 	COL name VAL loreal paris true match bakim yapan fondoten 4n beige COL market VAL 	1
COL name VAL loreal paris infaillible 24h matte fondoten 24 beige dore COL market VAL 	COL name VAL loreal paris infaillible 24h matte fondoten 24 beige dore COL market VAL 	1
COL name VAL loreal paris 24 saat kalici kalem no 300 COL market VAL 	COL name VAL loreal paris infaillible 24h goz kalemi 300 chocolate addiction COL market VAL 	1
COL name VAL loreal paris aydinlatici palet en glow warm glow firca seti COL market VAL 	COL name VAL loreal paris aydinlatici palet en glow warm glow firca seti COL market VAL 	0
COL name VAL loreal paris infaillible tum yuze uygulanabilir kapatici 322 ivory COL market VAL 	COL name VAL loreal paris infaillible tum yuze uygulanabilir kapatici 327 cashmere COL market VAL 	0
COL name VAL loreal paris color riche safari woman mat ruj 648 glamazone COL market VAL 	COL name VAL loreal paris color riche x balmain collection safari woman mat ruj 6 COL market VAL 	1
COL name VAL loreal paris infaillible 24h fresh wear 140 beige dore  kajal goz kalemi COL market VAL 	COL name VAL loreal paris infaillible 24h fresh wear 140 beige dorekajal goz kalemi COL market VAL 	1
COL name VAL loreal paris true match allik 163 nectarine COL market VAL 	COL name VAL loreal paris allik - true match le blush no 163 nectarine COL market VAL 	1
COL name VAL loreal paris color riche free the nudes ruj - no doubts COL market VAL 	COL name VAL loreal paris ruj - color riche free the nudes 03 no doubts COL market VAL 	1
COL name VAL loreal paris color riche x balmain collection safari woman mat ruj 648 glamazone COL market VAL 	COL name VAL loreal paris color riche safari woman mat ruj 648 glamazone COL market VAL 	1
COL name VAL loreal paris micellar makyaj temizleme suyu 400 ml COL market VAL 	COL name VAL loreal paris micellar makyaj temizleme suyu 400 ml yuz temizleme fircasi COL market VAL 	0
COL name VAL loreal paris ruj - color riche shine naked tans 659 blow your glow - nude COL market VAL 	COL name VAL loreal paris color riche shine naked tans ruj 656 beige in the city - nude COL market VAL 	1
COL name VAL loreal paris infaillible eye liner 306 stay blue COL market VAL 	COL name VAL loreal paris 24 saat kalici kalem no 306 stay blue COL market VAL 	1
COL name VAL loreal paris true match bakim yapan fondoten 45n true beige COL market VAL 	COL name VAL loreal paris true match bakim yapan fondoten 45n true beige COL market VAL 	1
COL name VAL loreal paris la vie en glow aydinlatici paleti cool glow - soguk tonlar COL market VAL 	COL name VAL loreal paris la vie en glow aydinlatici paleti cool glow - sicak tonlar COL market VAL 	0
COL name VAL loreal paris ruj - color riche free the nudes 05 no diktat COL market VAL 	COL name VAL loreal paris color richa ultra matte mat ruj no doubts COL market VAL 	1
COL name VAL loreal paris color riche plump  shine ruj 101 nectarine plump COL market VAL 	COL name VAL loreal paris loreal paris color riche plump  shine ruj COL market VAL 	0
COL name VAL loreal paris loreal paris color riche plump  shine ruj COL market VAL 	COL name VAL loreal paris color riche plump  shine ruj 101 nectarine plump COL market VAL 	0
COL name VAL loreal paris true match bakim yapan fondoten 5n sand fondoten COL market VAL 	COL name VAL loreal paris true match bakim yapan fondoten 45n true beige COL market VAL 	0
COL name VAL loreal paris kalem ruj no 915 COL market VAL 	COL name VAL loreal paris glam shine balmy gloss- 915 COL market VAL 	1
COL name VAL loreal paris rouge signature matte likit ruj 113 dont COL market VAL 	COL name VAL loreal paris rouge signature likit mat ruj - 113 i dont COL market VAL 	1
COL name VAL loreal paris brilliant signature plump in gloss ruj 410 i inflate COL market VAL 	COL name VAL loreal paris loreal paris brilliant signature plump in gloss ruj 404 i insert COL market VAL 	0
COL name VAL loreal botanicals loreal paris infallible longwear lip liner 001 highlight on point COL market VAL 	COL name VAL loreal paris infallible longwear lip liner 001 highlight on point COL market VAL 	0
COL name VAL loreal paris color riche shine ruj 111 instaheaven - pembe COL market VAL 	COL name VAL loreal paris ruj - color riche shine addiction lipstick 111 instaheaven COL market VAL 	1
COL name VAL loreal paris paris mega volume missbaby roll maskara black COL market VAL 	COL name VAL loreal paris miss baby roll siyah maskara COL market VAL 	1
COL name VAL loreal paris bambi oversized eye siyah maskara 2li set COL market VAL 	COL name VAL loreal paris loreal paris bambi oversized eye maskara - siyah 2li set 1 paket 1 x 2 adet COL market VAL 	0
COL name VAL loreal paris infaillible 24h tum yuze uygulanabilir kapatici - 328 lin COL market VAL 	COL name VAL loreal paris infaillible tum yuze uygulanabilir kapatici 326 vanilla COL market VAL 	0
COL name VAL loreal paris rouge signature metallic likit ruj - 205 i fascinate COL market VAL 	COL name VAL loreal paris likit metalik ruj - rouge signature metallic 205 i fascinate COL market VAL 	1
COL name VAL loreal paris infaillible dudak kalemi 105 red fiction- kirmizi COL market VAL 	COL name VAL loreal paris dudak kalemi - infaillible lip pencil 105 red fiction COL market VAL 	1
COL name VAL loreal paris kapatici - true match concealer 1n ivory COL market VAL 	COL name VAL loreal paris true match kapatici 1n ivory COL market VAL 	1
COL name VAL loreal paris paris waterproof crayon eyeliner 16 navy COL market VAL 	COL name VAL loreal paris infallible waterproof gel crayon eyeliner 16 navy life COL market VAL 	1
COL name VAL loreal paris true match bakim yapan fondoten 1n ivory fondoten COL market VAL 	COL name VAL loreal paris true match bakim yapan fondoten 1n ivory COL market VAL 	1
COL name VAL loreal paris color riche free the nudes ruj - no prejudice COL market VAL 	COL name VAL loreal paris ruj - color riche free the nudes 12 no prejudice COL market VAL 	1
COL name VAL loreal paris pudra - true match powder n4 beige COL market VAL 	COL name VAL loreal paris true match powder w7 cinnamon COL market VAL 	1
COL name VAL loreal paris loreal paris true match bakim yapan fondoten 4n beige COL market VAL 	COL name VAL loreal paris true match bakim yapan fondoten 15 linen COL market VAL 	0
COL name VAL loreal paris infaillible 24h matte cover yuksek kapatici fondoten 115 golden beige COL market VAL 	COL name VAL loreal paris infaillible 24h matte cover yuksek kapatici fondoten - 115 golden beige COL market VAL 	1
COL name VAL loreal paris siyah  paradise maskara COL market VAL 	COL name VAL loreal paris paradise siyah maskara COL market VAL 	1
COL name VAL loreal paris glow mon amour droplet highlight likit aydinlatici COL market VAL 	COL name VAL loreal paris likit aydinlatici - glow mon amour droplet highlight COL market VAL 	1
COL name VAL loreal paris true match bakim yapan fondoten 15 linen COL market VAL 	COL name VAL loreal paris loreal paris true match bakim yapan fondoten 4n beige COL market VAL 	0
COL name VAL loreal paris color riche plump  shine ruj 109 blue mint plump COL market VAL 	COL name VAL loreal paris loreal paris color riche plump  shine ruj COL market VAL 	0
COL name VAL loreal paris loreal paris lash paradise siyah maskara COL market VAL 	COL name VAL loreal paris loreal paris paradise maskara siyah maskara COL market VAL 	0
COL name VAL loreal paris true match bakim yapan fondoten 05n porcelain COL market VAL 	COL name VAL loreal paris true match bakim yapan fondoten 05r rose porcelain COL market VAL 	0
COL name VAL loreal paris loreal paris infaillible 32h fresh wear c vitaminli fondoten - 145 rose beige COL market VAL 	COL name VAL loreal paris infaillible 24h fondoten 145 rose beige COL market VAL 	1
COL name VAL loreal paris color riche les nus ruj 182 nu extreme COL market VAL 	COL name VAL loreal paris color riche les nus ruj 182 nu extreme COL market VAL 	0
COL name VAL loreal paris aydinlatici makyaj bazi - infaillible luminizing primer COL market VAL 	COL name VAL loreal paris infaillible aydinlatici makyaj bazi COL market VAL 	1
COL name VAL loreal paris loreal paris telescopic carbon siyah maskara maskara COL market VAL 	COL name VAL loreal paris telescopic siyah maskara 2li set COL market VAL 	0
COL name VAL loreal paris loreal paris unbelieva brow uzun sure kalici seffaf kas maskarasi COL market VAL 	COL name VAL loreal paris unbelieva brow uzun sure kalici seffaf kas maskarasi COL market VAL 	1
COL name VAL loreal paris ruj - color riche free the nudes 03 no doubts COL market VAL 	COL name VAL loreal paris color riche free the nudes ruj - no doubts COL market VAL 	1
COL name VAL loreal paris rouge signature lip topper dudak parlatici ruj - 212 pure gold COL market VAL 	COL name VAL loreal paris parlatici ruj - rouge signature lip topper 212 pure gold COL market VAL 	1
COL name VAL loreal paris true match bakim yapan fondoten 15 linen COL market VAL 	COL name VAL loreal paris loreal paris true match bakim yapan fondoten 15 linen COL market VAL 	1
COL name VAL loreal paris true match powder w7 cinnamon COL market VAL 	COL name VAL loreal paris pudra - true match powder w7 cinnamon COL market VAL 	1
COL name VAL loreal paris paradise extatic siyah maskara COL market VAL 	COL name VAL loreal paris loreal paris lash paradise siyah maskara maskara COL market VAL 	0
COL name VAL loreal paris stardust likit aydinlatici- 2018 yeni yil koleksiyonu COL market VAL 	COL name VAL likit aydinlatici - xmas stardust highlighting drops COL market VAL 	1
COL name VAL loreal paris likit mat ruj - rouge signature 113 i dont COL market VAL 	COL name VAL loreal paris rouge signature likit mat ruj - 113 i dont COL market VAL 	1
COL name VAL loreal paris loreal paris true match bakim yapan fondoten 4n beige COL market VAL 	COL name VAL loreal paris loreal paris true match bakim yapan fondoten 4n beige COL market VAL 	0
COL name VAL loreal paris les macarons likit mat ruj 826 mademoiselle mango COL market VAL 	COL name VAL loreal paris likit mat ruj - les macarons ultra matte liquid lipstick 826 mademoiselle mango COL market VAL 	1
COL name VAL loreal paris infaillible 24h fresh wear pudra fondoten 140 golden beige COL market VAL 	COL name VAL loreal paris infaillible 24h fresh wear pudra fondoten 140 golden beige COL market VAL 	1
COL name VAL loreal paris la petite far paleti - optimist COL market VAL 	COL name VAL loreal paris goz fari paleti - la petite palette optimist COL market VAL 	1
COL name VAL loreal paris loreal paris true match nude fondoten serum 2-3 light COL market VAL 	COL name VAL loreal paris true match nude fondoten serum 3-4 light medium COL market VAL 	0
COL name VAL loreal paris loreal paris infaillible 32h fresh wear c vitaminli fondoten - 220 sand COL market VAL 	COL name VAL loreal paris infaillible 24h fondoten - 220 sand COL market VAL 	1
COL name VAL loreal paris ruj - color riche shine naked tans 659 blow your glow - nude COL market VAL 	COL name VAL loreal paris color riche shine naked tans ruj 659 blow your glow - nude COL market VAL 	1
COL name VAL loreal paris telescopic siyah maskara 2li set COL market VAL 	COL name VAL loreal paris loreal paris telescopic maskara - siyah 1 paket COL market VAL 	0
COL name VAL loreal paris infaillible 24h fresh wear pudra fondoten 140 golden beige COL market VAL 	COL name VAL loreal paris infaillible 24 fresh wear fondoten 140 beige doregolden beige 30ml COL market VAL 	0
COL name VAL loreal paris cest magic bb krem 05 medium dark COL market VAL 	COL name VAL loreal paris cest magic bb krem 05 medium dark COL market VAL 	1
COL name VAL loreal paris telescopic carbon extra black maskara - siyah COL market VAL 	COL name VAL loreal paris loreal paris telescopic carbon black maskara siyah 8 mlmaskara COL market VAL 	0
COL name VAL loreal paris kadin pembe dolgunlastirici mat ruj 106 COL market VAL 	COL name VAL loreal paris color riche plump  shine ruj 106 pitaya plump COL market VAL 	1
COL name VAL loreal paris infaillable automatic jel goz kalemi - mavi COL market VAL 	COL name VAL loreal paris loreal paris infaillable automatic jel goz kalemi - mavi COL market VAL 	1
COL name VAL loreal paris loreal paris infaillible 24h tum yuze uygulanabilir kapatici - 330 pecan COL market VAL 	COL name VAL loreal paris infaillible tum yuze uygulanabilir kapatici 330 pecan COL market VAL 	0
COL name VAL loreal paris infaillible tum yuze uygulanabilir kapatici 323 fawn COL market VAL 	COL name VAL loreal paris loreal paris infaillible tum yuze uygulanabilir kapatici 338 honey COL market VAL 	0
COL name VAL loreal paris true match bakim yapan fondoten 1d golden ivory COL market VAL 	COL name VAL loreal paris true match bakim yapan fondoten 1d golden ivory COL market VAL 	1
COL name VAL loreal paris les macarons ultra matte likit ruj 830 blackcurrant COL market VAL 	COL name VAL loreal paris likit mat ruj - les macarons ultra matte liquid lipstick 830 blackcurrant crush COL market VAL 	1
COL name VAL loreal paris color riche shine naked tans ruj 658 topless - nude COL market VAL 	COL name VAL loreal paris loreal paris color riche shine naked tans ruj 656 beige in the city - nude COL market VAL 	1
COL name VAL loreal paris loreal paris true match bakim yapan fondoten 4n beige COL market VAL 	COL name VAL loreal paris true match bakim yapan fondoten 3n creamy beige COL market VAL 	0
COL name VAL loreal paris loreal paris altin mirage goz fari 02 pembe kuvars - sinirli uretimozel koleksiyon COL market VAL 	COL name VAL loreal paris gold mirage pink quartz COL market VAL 	1
COL name VAL loreal paris infaillible tum yuze uygulanabilir kapatici 322 ivory COL market VAL 	COL name VAL loreal paris infaillible tum yuze uygulanabilir kapatici 321 eggshell COL market VAL 	0
COL name VAL loreal paris true match bakim yapan fondoten 2r rose vanilla COL market VAL 	COL name VAL loreal paris loreal paris true match bakim yapan fondoten 2r rose vanilla COL market VAL 	0
COL name VAL loreal paris likit aydinlatici - glow mon amour droplet highlight 03 bronze in love COL market VAL 	COL name VAL loreal paris glow mon amour likit aydinlatici 03 bronze in love COL market VAL 	1
COL name VAL loreal paris likit mat ruj - rouge signature COL market VAL 	COL name VAL loreal paris rouge signature likit mat ruj - 116 i explore COL market VAL 	0
COL name VAL loreal paris kahverengi goz kalemi - contour kohl 135 brown COL market VAL 	COL name VAL loreal paris contour khol goz kalemi 135 brown COL market VAL 	1
COL name VAL loreal paris true match bakim yapan fondoten 1r rose ivory COL market VAL 	COL name VAL loreal paris true match bakim yapan fondoten 1n ivory COL market VAL 	0
COL name VAL loreal paris infaillible tum yuze uygulanabilir kapatici 326 vanilla COL market VAL 	COL name VAL loreal paris loreal paris infaillible tum yuze uygulanabilir kapatici 338 honey COL market VAL 	0
COL name VAL loreal paris infaillible shaping stick allik 001 sexy flush COL market VAL 	COL name VAL loreal paris infaillible shaping stick sexy flush allik 001 COL market VAL 	1
COL name VAL loreal paris aydinlatici palet en glow warm glow firca seti COL market VAL 	COL name VAL loreal paris aydinlatici palet en glow warm glow firca seti COL market VAL 	1
COL name VAL loreal paris brow artist high contour 107 cool brunette - koyu kumral COL market VAL 	COL name VAL loreal paris kas kalemi - brow artist high contour 107 cool brown COL market VAL 	1
COL name VAL loreal paris true match bakim yapan fondoten 9n truffe COL market VAL 	COL name VAL loreal paris true match bakim yapan fondoten 9n truffe COL market VAL 	1
COL name VAL loreal paris true match bakim yapan fondoten 3n creamy beige 03600522862406 COL market VAL 	COL name VAL loreal paris true match bakim yapan fondoten 3n creamy beige COL market VAL 	1
COL name VAL loreal paris loreal paris infaillible 24h tum yuze uygulanabilir kapatici - 330 pecan COL market VAL 	COL name VAL loreal paris infaillible tum yuze uygulanabilir kapatici 326 vanilla COL market VAL 	0