COL name VAL L'oreal paris Unlimited Maskara Siyah	COL name VAL L'Oreal Paris Unlimited Siyah Maskara	1
COL name VAL L'oreal paris Infaillible 24h Matte Cover YÃ¼ksek KapatÄ±cÄ± FondÃ¶ten 115 Golden Beige	COL name VAL L'OrÃ©al Paris Infaillible 24H Matte Cover YÃ¼ksek KapatÄ±cÄ± FondÃ¶ten - 290 Golden Amber	0
COL name VAL L'oreal paris Lash Paradise Intense Black Ekstra Siyah Maskara 2'li Set ve Ayna	COL name VAL Loreal Paris L'orÃ©al Paris Lash Paradise Intense Black Ekstra Siyah Maskara 2'li Set 1 Paket (1 x 2 Adet	0
COL name VAL Loreal Paris Eye Paint GÃ¶z FarÄ± No: 204 Over The Blue	COL name VAL Loreal botanicals Loreal Eye Paint GÃ¶z FarÄ± No: 204 Over The Blue	0
COL name VAL L'oreal paris Normal & Karma Ve Hassas Ciltler IÃ§in Micellar Kusursuz Makyaj Temizleme Suyu 400 Ml	COL name VAL L'Oreal ParisÂ Micellar Makyaj Temizleme Suyu Normalden Ve Karmaya Hassas Ciltler Ä°Ã§in 200 ml	0
COL name VAL L'OrÃ©al Paris Infallible Waterproof Gel Crayon Eyeliner 17 Christmas Day	COL name VAL L'oreal paris Paris Waterproof Crayon Eyeliner 17 Christmas	1
COL name VAL L'oreal paris Rouge Signature Likit Mat Ruj - 113 I Don't	COL name VAL L'OrÃ©al Paris Rouge Signature Likit Mat Ruj - 113 I don't	1
COL name VAL L'oreal paris Ruj - Infallible Mega Gloss 407 Smoke Me Up	COL name VAL L'OrÃ©al Paris Mega Gloss Lip Gloss 407 SMOKE ME UP	1
COL name VAL L'oreal paris Ruj - Color Riche Free The Nudes 03 No Doubts	COL name VAL L'OrÃ©al Paris Color Riche Free The Nudes Ruj - No Diktat	1
COL name VAL L'oreal paris Bambi Eye Ceylan GÃ¶z Etkili Siyah Maskara 30175792	COL name VAL L'oreal Paris Bambi Eye Extra Black Ceylan GÃ¶z Etkili Maskara Ekstra Siyah	0
COL name VAL L'OrÃ©al Paris True Match Pudra C1 ROSE IVORY	COL name VAL L'oreal paris Pudra - True Match Powder C1 Rose Ivory	1
COL name VAL L'oreal paris L'orÃ©al Paris Rouge Signature Empowereds Likit Mat Ruj - 140 Desired	COL name VAL L'OrÃ©al Paris Rouge Signature Empowereds Likit Mat Ruj - 140 Desired	1
COL name VAL L'OrÃ©al Paris True Match BakÄ±m Yapan FondÃ¶ten 5D Golden Sand	COL name VAL L'oreal paris L'orÃ©al Paris True Match BakÄ±m Yapan FondÃ¶ten 5n Sand	0
COL name VAL L'oreal paris Rouge Signature Likit Mat Ruj 114 I Represent	COL name VAL L'OrÃ©al Paris Rouge Signature Likit Mat Ruj - 114 I represent	1
COL name VAL Loreal Paris Volume Million Lashes Maskara	COL name VAL L'oreal paris Volume Million Lashes Balm Noir Maskara	0
COL name VAL L'OrÃ©al Paris Infaillible 24H FondÃ¶ten 125 NATURAL ROSE	COL name VAL L'oreal paris L'OrÃ©al Paris Infaillible 32H Fresh Wear C Vitaminli FondÃ¶ten - 125 Natural Beige	1
COL name VAL L'OrÃ©al Paris Brow Artist Xpert No 106 Grey Brunette	COL name VAL L'oreal paris KaÅŸ Kalemi - Brow Artist Xpert 106 Grey Brune	1
COL name VAL L'oreal paris Uzun SÃ¼re KalÄ±cÄ± FondÃ¶ten Infallible 24h Foundation 230 Golden 30 ml	COL name VAL L'OrÃ©al Paris Infaillible 24H FondÃ¶ten 230 RADIANT HONEY	1
COL name VAL L'oreal paris Likit Mat Ruj - Infallible Lip Paint Nude Paint Matte 210 Dead Lips	COL name VAL L'OrÃ©al Paris Infallible Lip Paint Matte Ruj No 210 - Dead Lips	1
COL name VAL L'oreal paris L'orÃ©al Paris True Match BakÄ±m Yapan FondÃ¶ten 4n BeÄ±ge	COL name VAL L'Oreal  Paris True Match BakÄ±m Yapan FondÃ¶ten 4N Beige	1
COL name VAL L'OrÃ©al Paris Infaillible 24H FondÃ¶ten - 300 Amber	COL name VAL L'OrÃ©al Paris Infaillible 24H FondÃ¶ten 300 Amber	1
COL name VAL L'oreal paris Telescopic Carbon Extra Black Maskara - Siyah	COL name VAL Loreal Paris L'oreal Paris Telescopic Carbon Siyah Maskara Maskara	0
COL name VAL L'oreal paris Loreal Air Volume Easy Waterproof Suya DayanÄ±klÄ± Maskara Siyah	COL name VAL Loreal Paris L'orÃ©al Paris Air Volume Mega Easy Waterproof Suya DayanÄ±klÄ± Maskara - Siyah	0
COL name VAL L'OrÃ©al Paris Les Macarons Likit Mat Ruj 820 Praline De Paris	COL name VAL L'Oreal Paris Les Macarons Ultra Matte Liquid Lipstick Ruj 820 Pral	1
COL name VAL L'Oreal Paris Kalem Ruj No: 915	COL name VAL L'oreal paris Glam Shine Balmy Gloss- 915	1
COL name VAL L'oreal paris Ruj - Color Riche Privee Nudes - JLO's Nude	COL name VAL L'OrÃ©al Paris Color Riche Ruj Privee JLO'S NUDE	1
COL name VAL L'oreal paris ParlatÄ±cÄ± Ruj - Rouge Signature Lip Topper 210 White Gold	COL name VAL L'OrÃ©al Paris Rouge Signature Lip Topper Dudak ParlatÄ±cÄ± Ruj - 210 White Gold	1
COL name VAL L'OrÃ©al Paris Infaillible Magic Essence Drops Likit Makyaj BazÄ±	COL name VAL L'oreal paris Likit Makyaj BazÄ± - Infaillible Magic Essence Drops	1
COL name VAL L'oreal paris L'orÃ©al Paris True Match BakÄ±m Yapan FondÃ¶ten 4n BeÄ±ge	COL name VAL L'OrÃ©al Paris True Match BakÄ±m Yapan FondÃ¶ten 4.5N True BeÄ±ge	0
COL name VAL L'OrÃ©al Paris Infaillible 24H Matte FondÃ¶ten 11 VANILLE	COL name VAL L'oreal paris Infaillible 24h Matte FondÃ¶ten 11 VanÄ±lle	1
COL name VAL L'OrÃ©al Paris Brow Artist Micro Tattoo 105 Brunette - Kumral	COL name VAL L'oreal paris KaÅŸ Kalemi - Brow Artist Micro Tattoo 105 Brunette	1
COL name VAL L'OrÃ©al Paris Color Riche Free The Nudes Ruj - No Doubts	COL name VAL L'oreal paris Ruj - Color Riche Free The Nudes 05 No Diktat	1
COL name VAL L'oreal paris Ruj - Labial Color Riche Caresse Lipstick 07 Cheeky Magenta	COL name VAL L'OrÃ©al Paris Rouge Caresse - Ruj 07 Cheeky Magenta	1
COL name VAL L'oreal paris Uzun SÃ¼re KalÄ±cÄ± FondÃ¶ten - Infallible 24H Foundation 125 Naturel Rose 30 ml	COL name VAL L'OrÃ©al Paris Infaillible 24H FondÃ¶ten 125 NATURAL ROSE	1
COL name VAL L'OrÃ©al Paris Miss Baby Roll Siyah Maskara	COL name VAL L'oreal paris Paris Mega Volume Missbaby Roll Maskara Black	1
COL name VAL L'OrÃ©al Paris Les Chocolats Likit Mat Ruj 852 Box Of Chocolates	COL name VAL L'oreal paris Likit Mat Ruj - Les Chocolats Ultra Matte Liquid Lipstick 852 Box Of Chocolates	1
COL name VAL L'oreal paris KaÅŸ Kalemi - Brow Artist High Contour 108 Warm Brown	COL name VAL L'OrÃ©al Paris Brow Artist High Contour 105 Brunette - Kumral	1
COL name VAL L'Oreal Paris 24 Saat KalÄ±cÄ± Kalem No 306 Stay Blue	COL name VAL L'oreal paris Ä°nfaillible Eye Liner 306 Stay Blue	1
COL name VAL L'oreal paris Color Riche Intense Volume Matte Ruj - 603 Wood Nonchalant	COL name VAL L'orÃ©al Paris Color Riche Intense Volume Matte Ruj - 603 Wood Nonchalant	1
COL name VAL L'oreal paris Mat Gri Superliner - Superliner Mat Matic 03 Taupe Grey	COL name VAL Loreal Paris Super Liner Gelmatic 03 Taupe Grey - Gri GÃ¶z Kalemi	1
COL name VAL L'OrÃ©al Paris Infaillible TÃ¼m YÃ¼ze Uygulanabilir KapatÄ±cÄ± 326 Vanilla	COL name VAL L'Oreal Paris L'orÃ©al Paris Infaillible TÃ¼m YÃ¼ze Uygulanabilir KapatÄ±cÄ± 326 Vanilla	1
COL name VAL Loreal Paris L'orÃ©al Paris Lash Paradise Intense Black Ekstra Siyah Maskara	COL name VAL L'oreal paris Lash Paradise Intense Black Ekstra Siyah Maskara	0
COL name VAL L'oreal paris L'orÃ©al Paris True Match BakÄ±m Yapan FondÃ¶ten 5d Golden Sand	COL name VAL L'Oreal Paris True Match BakÄ±m Yapan FondÃ¶ten 5D Golden Sand	1
COL name VAL L'oreal paris L'orÃ©al Paris Bambi Eye Oversized Ceylan GÃ¶z Etkili Maskara - Siyah	COL name VAL L'orÃ©al Paris Bambi Eye Oversized Ceylan GÃ¶z Etkili Maskara - Siyah	1
COL name VAL L'oreal paris Kahverengi GÃ¶z Kalemi - Contour Khol Kajal 102 Espresso	COL name VAL Loreal Paris Color Riche Lekhol GÃ¶z Kalemi-102 Pure Expresso	1
COL name VAL L'OrÃ©al Paris Infaillible Eye Paint GÃ¶z FarÄ± 101 Eternal White	COL name VAL L'oreal paris GÃ¶z FarÄ± - Infaillible Eyeshadow Paint 101 Eternal White	1
COL name VAL L'oreal paris L'orÃ©al Paris True Match BakÄ±m Yapan FondÃ¶ten 7d Golden Amber	COL name VAL L'OrÃ©al Paris True Match BakÄ±m Yapan FondÃ¶ten 1D Golden Ivory	0
COL name VAL L'oreal paris True Match BakÄ±m Yapan FondÃ¶ten 2r Rose	COL name VAL L'orÃ©al Paris True Match BakÄ±m Yapan FondÃ¶ten 1r Rose Ivory	0
COL name VAL Loreal Paris Color Queen Tekli GÃ¶z FarÄ± 31 Crowned	COL name VAL L'oreal paris Loreal Color Queen Tekli GÃ¶z FarÄ± 20 Queen	0
COL name VAL L'OrÃ©al Paris True Match BakÄ±m Yapan FondÃ¶ten 9N Truffe	COL name VAL L'oreal paris L'OrÃ©al Paris True Match BakÄ±m Yapan FondÃ¶ten 1.5 Linen	0
COL name VAL L'oreal paris Suya DayanÄ±klÄ± Siyah Maskara - Unlimited Very Different Waterproof Mascara Black	COL name VAL L'OrÃ©al Paris Unlimited Very Different Waterproof Suya DayanÄ±klÄ± Maskara	1
COL name VAL L'Oreal Paris Unlimited Siyah Maskara	COL name VAL L'oreal paris Unlimited Maskara Siyah	1
COL name VAL L'OrÃ©al Paris Color Riche x Balmain Collection Rock Woman Mat Ruj 901 Rebellion	COL name VAL L'oreal paris Color Riche Rock Woman Mat Ruj 901 Rebellion	1
COL name VAL Loreal Paris Loreal Color Riche Lipstick 163 Orange Magique	COL name VAL L'oreal paris KadÄ±n 163 Orange Magique Ruj	1
COL name VAL L'oreal paris YeÅŸil Eyeliner - Infallible Stylo Eyeliner 24H 313 Irresistible Kaki	COL name VAL L'OrÃ©al Paris Infaillible 24H GÃ¶z Kalemi 313 IRRESISTABLE KHAKI	1
COL name VAL L'oreal paris Loreal Color Queen Tekli GÃ¶z FarÄ± 32 Commander	COL name VAL L'OrÃ©al Paris Color Queen Tekli GÃ¶z FarÄ± 32 Commander	1
COL name VAL L'oreal paris Likit Ruj - Color Riche L'Extraordinaire Lipstick 204 Tangerine Sonate	COL name VAL L'OrÃ©al Paris Extraordinaire 204 Tangerine	1
COL name VAL L'oreal paris Skin Paradise Su BazlÄ± Renkli Nemlendirici 01 Light	COL name VAL L'Oreal Paris Skin Paradise Su BazlÄ± Renkli Nemlendirici 01 Light	1
COL name VAL L'OrÃ©al Paris Ä°nfaillible Eye Liner 306 Stay Blue	COL name VAL L'oreal paris Ä°nfaillible Eye Liner 306 Stay Blue	1
COL name VAL L'OrÃ©al Paris Nude Magique CC Krem Yorgun Cilt KarÅŸÄ±tÄ± ANTI FATIGUE	COL name VAL L'oreal paris Yorgunluk Ä°zleri KarÅŸÄ±tÄ± CC Krem - Nude Magique 30 ml	1
COL name VAL L'OrÃ©al Paris Color Riche Shine Naked Tans Ruj 656 Beige In The City - Nude	COL name VAL L'oreal paris L'orÃ©al Paris Color Riche Shine Naked Tans Ruj 656 Beige In The City - Nude	1
COL name VAL L'oreal paris KapatÄ±cÄ± - True Match Concealer Golden Honey	COL name VAL L'OrÃ©al Paris True Match KapatÄ±cÄ± 6D/W Golden Honey	1
COL name VAL L'OrÃ©al Paris Brow Artist Skinny Definer KaÅŸ Kalemi - 109 Ebony	COL name VAL L'oreal paris Brow Artist Skinny Definer KaÅŸ Kalemi 109 Ebony	1
COL name VAL Loreal Paris L'oreal Paris Telescopic Carbon Siyah Maskara Maskara	COL name VAL L'oreal paris Telescopic Siyah Maskara 2'li Set	0
COL name VAL L'oreal paris True Match BakÄ±m Yapan FondÃ¶ten 1R ROSE IVORY	COL name VAL L'OrÃ©al Paris True Match BakÄ±m Yapan FondÃ¶ten 1R ROSE IVORY	0
COL name VAL L'oreal paris Color Riche Safari Woman Mat Ruj 905 Balmain Instinct	COL name VAL L'OrÃ©al Paris Color Riche x Balmain Collection Safari Woman Mat Ruj 905 Balmain Instinct	1
COL name VAL L'oreal paris Unlimited Siyah Maskara 2 Li Set	COL name VAL L'OrÃ©al Paris Unlimited Siyah Maskara	0
COL name VAL Loreal Paris Maskara	COL name VAL L'oreal paris Bambi Eye Ceylan GÃ¶z Etkili Suya DayanÄ±klÄ± Maskara - Siyah 30178625	1
COL name VAL L'oreal paris L'OrÃ©al Paris Infaillible 24H TÃ¼m YÃ¼ze Uygulanabilir KapatÄ±cÄ± - 326 Vanilla	COL name VAL L'OrÃ©al Paris Infaillible TÃ¼m YÃ¼ze Uygulanabilir KapatÄ±cÄ± 326 Vanilla	1
COL name VAL L'Oreal Paris Ruj Lip Paint Metallic 306 Lolita	COL name VAL L'oreal paris Ruj - Lip Paint Metallic 306 Lolita	1
COL name VAL L'oreal paris GÃ¶z FarÄ± - Infallible Eyeshadow Paint 301 Pure Purple	COL name VAL L'OrÃ©al Paris Infaillible Eye Paint GÃ¶z FarÄ± 301 Pure Purple	1
COL name VAL Loreal Paris L'orÃ©al Paris Color Riche Free The Nudes Ruj - No Cliche	COL name VAL L'oreal paris Ruj - Color Riche Free The Nudes 04 No Cage	0
COL name VAL L'OrÃ©al Paris True Match BakÄ±m Yapan FondÃ¶ten 2N VanÄ±lla	COL name VAL L'oreal paris True Match Foundation 2n Vanilla FondÃ¶ten -	1
COL name VAL L'oreal paris L'orÃ©al Paris Color Riche Plump & Shine Ruj	COL name VAL L'OrÃ©al Paris Color Riche Plump & Shine Ruj 109 Blue Mint Plump	0
COL name VAL L'oreal paris Loreal Rouge Signature Likit Mat Ruj 103 I Enjoy	COL name VAL Loreal Paris L'oreal Paris Rouge Signature Likit Mat Ruj - 103 Enjoy Ruj	0
COL name VAL L'OrÃ©al Paris Extraordinaire 204 Tangerine	COL name VAL L'oreal paris Likit Ruj - Color Riche L'Extraordinaire Lipstick 204 Tangerine Sonate	1
COL name VAL L'OrÃ©al Paris Le Liner Signature GÃ¶z Kalemi 03 Rouge Noir Angora	COL name VAL L'oreal paris Le Liner Signature  Rouge Noir Angora GÃ¶z Kalemi 03 30176461	1
COL name VAL L'oreal paris KapatÄ±cÄ± - True Match Concealer 4n Beige	COL name VAL L'OrÃ©al Paris True Match KapatÄ±cÄ± - 4N Beige	1
COL name VAL L'OrÃ©al Paris Infaillible TÃ¼m YÃ¼ze Uygulanabilir KapatÄ±cÄ± 330 Pecan	COL name VAL L'oreal paris L'OrÃ©al Paris Infaillible TÃ¼m YÃ¼ze Uygulanabilir KapatÄ±cÄ± 338 Honey	0
COL name VAL L'OrÃ©al Paris Infaillible Shaping Stick AydÄ±nlatÄ±cÄ± 502 Gold is cold	COL name VAL L'oreal paris Stick AydÄ±nlatÄ±cÄ± - Infaillible Shaping Stick 502 Gold is Cold	1
COL name VAL L'oreal paris Mat Ruj - Color Riche Matte Addiction Lipstick 633 Moka Chic- Nude	COL name VAL L'OrÃ©al Paris Color Riche Matte Addiction Ruj 633 Moka Chic- Nude	1
COL name VAL L'oreal paris Likit Ruj - Color Riche L'Extraordinaire Lipstick 304 Ruby Opera	COL name VAL L'OrÃ©al Paris Extraordinaire 304 Ruby Opera	1
COL name VAL L'oreal paris Likit Mat Ruj - Les Macarons Ultra Matte Liquid Lipstick 834 Infinite Spice	COL name VAL L'Oreal Paris Ral Inf.Macaronsnu Ruj 834 Infinite Sp	1
COL name VAL L'OrÃ©al Paris Color Riche x Balmain Collection Rock Woman Mat Ruj 467 Freedom	COL name VAL L'oreal paris Color Riche Rock Woman Mat Ruj 467 Freedom	1
COL name VAL Loreal Paris Air Volume Mega Mascara 9.4ml	COL name VAL L'oreal paris Air Volume Mega Mascara 9.4ml	0
COL name VAL L'oreal paris Mavi GÃ¶z Kalemi - Super Liner Silkissime 603	COL name VAL L'OrÃ©al Paris Super Liner Silkissime Mavi 603	1
COL name VAL L'oreal paris Stick AllÄ±k - Infaillible Shaping Stick AllÄ±k 002 Nude In Rose	COL name VAL L'OrÃ©al Paris Infaillible Shaping Stick AllÄ±k 002 Nude Ä°n Rose	1
COL name VAL L'oreal paris Infaillible 24h Matte FondÃ¶ten 30 MÄ±el Honey	COL name VAL L'OrÃ©al Paris Infaillible 24H Matte FondÃ¶ten 30 Miel Honey	1
COL name VAL L'OrÃ©al Paris True Match BakÄ±m Yapan FondÃ¶ten 1.5 LÄ±nen	COL name VAL L'oreal paris L'orÃ©al Paris True Match BakÄ±m Yapan FondÃ¶ten 4n BeÄ±ge	0
COL name VAL L'Oreal Paris Lash Sensational Yelpaze Etkili Maskara Burgundy Brown	COL name VAL L'oreal paris Lash Sensational Yelpaze Etkili Burgundy Brown Maskara	1
COL name VAL L'Oreal Paris Les Chocolats Ultra Matte Likit Ruj 856 %70 Yum	COL name VAL L'OrÃ©al Paris Les Chocolats Likit Mat Ruj 856 70% Yum	1
COL name VAL L'oreal paris Gri Eyeliner - Infallible Gel Crayon Eyeliner 02 Grey	COL name VAL L'OrÃ©al Paris Infaillible Paint Gel Crayon Eyeliner 02 Grey Fever	1
COL name VAL L'OrÃ©al Paris Mascara Telescopic Black	COL name VAL L'oreal paris Mascara Telescopic Black._	0
COL name VAL L'Oreal Paris Color Riche Les Nus Ruj 179 Decadent	COL name VAL L'OrÃ©al Paris Color Riche Les Nus Ruj 179 Nu Decadent	1
COL name VAL L'oreal paris Ruj - Xmas Color Riche Lipstick Lipstick Burning Red	COL name VAL L'OrÃ©al Paris Xmas Color Riche Lipstick Lipstick Burning Red	1
COL name VAL L'OrÃ©al Paris True Match BakÄ±m Yapan FondÃ¶ten 7R ROSE AMBER	COL name VAL L'oreal paris L'orÃ©al Paris True Match BakÄ±m Yapan FondÃ¶ten 7r Rose Amber	1
COL name VAL L'Oreal Paris Les Chocolats Ultra Matte Likit Ruj 864 Tasty Ruby	COL name VAL L'OrÃ©al Paris Les Chocolats Likit Mat Ruj 864 Tasty Ruby	1
COL name VAL L'oreal paris Unbelieva Brow Uzun SÃ¼re KalÄ±cÄ± KaÅŸ Jeli -105 Brunette	COL name VAL Loreal Paris Lâ€™orÃ©al Paris Uzun SÃ¼re KalÄ±cÄ± KaÅŸ Jeli Unbelieva Brow - 105 Brunette	1
COL name VAL L'oreal paris True Match BakÄ±m Yapan FondÃ¶ten 4.5n True BeÄ±ge	COL name VAL L'Oreal Paris True Match BakÄ±m Yapan FondÃ¶ten 4.5N True Beige	1
COL name VAL L'OrÃ©al Paris Infaillible 24H Matte FondÃ¶ten 24 BEIGE DORE	COL name VAL L'oreal paris Mat FondÃ¶ten - Infaillible 24h Matte 24 Golden Beige 35 ml	1
COL name VAL L'oreal Paris True Match BakÄ±m Yapan FondÃ¶ten 5n Sand FondÃ¶ten	COL name VAL L'oreal paris True Match BakÄ±m Yapan FondÃ¶ten 0.5n PorcelaÄ±n	0
COL name VAL L'oreal paris Ruj - Color Riche Lipstick 134 Pink Panac	COL name VAL L'OrÃ©al Paris Color Riche Ruj 134 PINK PANAC	1
COL name VAL L'oreal paris Volume Million Lashes So Couture Mascara	COL name VAL Loreal Paris Volume Million Lashes Mascara Black	1
COL name VAL L'oreal paris FondÃ¶ten Infallible 220 Sable	COL name VAL L'OrÃ©al Paris Infallible 220 Sable Sand FondÃ¶ten	1
COL name VAL L'oreal paris Likit Mat Ruj - Les Chocolats Ultra Matte Liquid Lipstick 852 Box Of Chocolates	COL name VAL L'OrÃ©al Paris Les Chocolats Likit Mat Ruj 852 Box Of Chocolates	1
COL name VAL L'OrÃ©al Paris Unlimited  KaldÄ±rma Etkili Siyah Maskara 7,4 ml	COL name VAL L'oreal paris L'orÃ©al Paris Unlimited KaldÄ±rma Etkili Siyah Maskara 7,4 Ml	1
COL name VAL L'orÃ©al Paris Telescopic Carbon Black Maskara - Siyah 2'li Set	COL name VAL L'oreal paris Telescopic Carbon Extra Black Maskara - Siyah	0
COL name VAL L'OrÃ©al Paris Superliner Smokissime Eyeliner BLACK	COL name VAL L'oreal paris Siyah Eyeliner - Smokissime Superliner 100 Black	1
COL name VAL L'orÃ©al Paris True Match BakÄ±m Yapan FondÃ¶ten 1r Rose Ivory	COL name VAL L'oreal paris True Match BakÄ±m Yapan FondÃ¶ten 2r Rose	0
COL name VAL L'oreal paris L'OrÃ©al Paris Infaillible 32H Fresh Wear C Vitaminli FondÃ¶ten - 130 True Beige	COL name VAL L'OrÃ©al Paris Infaillible 24H FondÃ¶ten 130 TRUE BEIGE	1
COL name VAL L'oreal paris Glow Paradise Ruj Balm-in-lipstick 244 Apricot Desire-kayÄ±sÄ±  3600523687114-244	COL name VAL L'orÃ©al Paris Color Riche Plump & Shine Ruj 101 Nectarine Plump	1
COL name VAL L'OrÃ©al Paris Superliner Ultra Precision Siyah Eyeliner	COL name VAL L'oreal paris Siyah Eyeliner - Ultra Precision Superliner 01	1
COL name VAL L'OrÃ©al Paris Bambi Eye Ceylan GÃ¶z Etkili Maskara - Siyah	COL name VAL L'oreal paris Bambi Eye Extra Black Ceylan GÃ¶z Etkili Maskara Ekstra Siyah	0
COL name VAL L'oreal paris Ruj - Labial Color Riche Caresse Lipstick 203 Rock'N Mauve	COL name VAL L'OrÃ©al Paris Rouge Caresse 203 Rocknmauve Ruj	1
COL name VAL L'oreal paris L'orÃ©al Paris True Match Pudra W5 Golden Sand	COL name VAL L'OrÃ©al Paris True Match Pudra 5.D/5.W Golden Sand	1
COL name VAL L'oreal paris Infaillible 24h Matte Cover YÃ¼ksek KapatÄ±cÄ± FondÃ¶ten 155 Natural Rose	COL name VAL L'OrÃ©al Paris Infaillible 24H Matte Cover YÃ¼ksek KapatÄ±cÄ± FondÃ¶ten - 155 Natural Rose	1
COL name VAL L'OrÃ©al Paris Paradise KayÄ±sÄ± Kokulu Turuncu Maskara	COL name VAL L'oreal paris Paradise KayÄ±sÄ± Kokulu Maskara	1
COL name VAL Loreal Paris L'oreal Paris True Match BakÄ±m Yapan FondÃ¶ten 4n Beige	COL name VAL L'oreal paris True Match BakÄ±m Yapan FondÃ¶ten 3D GOLDEN BEIGE	0
COL name VAL L'Oreal Paris Color Richa Ultra Matte Mat Ruj No Doubts	COL name VAL L'OrÃ©al Paris Color Riche Free The Nudes Ruj - No Hesitation	1
COL name VAL L'OrÃ©al Paris True Match KapatÄ±cÄ± 3R/C Rose Beige	COL name VAL L'oreal paris KapatÄ±cÄ± - True Match Concealer 3R/C Rose Beige	1
COL name VAL L'oreal paris L'OrÃ©al Paris True Match BakÄ±m Yapan FondÃ¶ten 5R ROSE SAND	COL name VAL L'OrÃ©al Paris True Match BakÄ±m Yapan FondÃ¶ten 7R ROSE AMBER	0
COL name VAL L'oreal paris Likit AydÄ±nlatÄ±cÄ± - Glow Mon Amour Droplet Highlight 03 Bronze In Love	COL name VAL L'OrÃ©al Paris Glow Mon Amour Likit AydÄ±nlatÄ±cÄ± 03 Bronze In Love	1
COL name VAL Loreal Paris True Match FondÃ¶ten 3n Creamy Beige	COL name VAL L'oreal paris True Match BakÄ±m Yapan FondÃ¶ten 3N CREAMY BEIGE	0
COL name VAL L'OrÃ©al Paris Infaillible Lip Paint Likit Ruj Matte 204 Red Actually	COL name VAL L'oreal paris Likit Mat Ruj - Infallible Lip Paint Matte 204 Red Actually	1
COL name VAL L'oreal paris L'orÃ©al Paris True Match Nude FondÃ¶ten Serum 3-4 Light Medium	COL name VAL L'OrÃ©al Paris True Match Nude FondÃ¶ten Serum 2-3 Light	0
COL name VAL L'OrÃ©al Paris Infallible Waterproof Gel Crayon Eyeliner 06 Golden Woman	COL name VAL L'oreal paris Dudak Kalemi - Infaillible Lip Pencil 06 Golden Woman	1
COL name VAL L'OrÃ©al Paris Bronze Please! BronzlaÅŸtÄ±rÄ±cÄ± Pudra 03 Amalfi Medio	COL name VAL L'oreal paris Bronze Please! BronzlaÅŸtÄ±rÄ±cÄ± Pudra 03 Amalfi	1
COL name VAL L'oreal paris L'OrÃ©al Paris Bambi Eye Ceylan GÃ¶z Etkili Maskara - Siyah	COL name VAL Loreal Paris Bambi Eye Ceylan GÃ¶z Etkili Maskara - Siyah X2	0
COL name VAL L'oreal paris Tekli GÃ¶z FarÄ± - Color Queen Mono Eyeshadow 37 Extraordinnaire 30173354	COL name VAL L'OrÃ©al Paris Color Queen Tekli GÃ¶z FarÄ± 37 Extraordinnaire	1
COL name VAL L'OrÃ©al Paris Infallible Lip Paint Matte Ruj No 210 - Dead Lips	COL name VAL L'oreal paris Likit Mat Ruj - Infallible Lip Paint Nude Paint Matte 210 Dead Lips	1
COL name VAL L'oreal paris GÃ¶z FarÄ± Quadnu P3 Emeraldconquest	COL name VAL L'OrÃ©al Paris Far Color Riche Quadro P3 GÃ¶z FarÄ±	1
COL name VAL L'OrÃ©al Paris Color Riche Matte Addiction Ruj 634 Greige Perfecto - Kahverengi	COL name VAL L'oreal paris Mat Ruj - Color Riche Matte Addiction Lipstick 634 Geige Hype	1
COL name VAL L'OrÃ©al Paris Superstar XFiber Siyah Maskara	COL name VAL L'oreal paris Siyah Maskara - False Lash Superstar X Fiber Mascara 01 Black	1
COL name VAL L'oreal paris AllÄ±k ve BronzlaÅŸtÄ±rÄ±cÄ± Pudra - Blush Cherie On The Cake Bronzer 02 Dark Chocolate	COL name VAL L'orÃ©al Paris Cherie On The Cake AllÄ±k ve BronzlaÅŸtÄ±rÄ±cÄ± Pudra - 02 Dark Chocolate	1
COL name VAL L'OrÃ©al Paris Bambi Oversized Eye Siyah Maskara + Ayna	COL name VAL L'oreal paris Siyah Maskara Bambi Eye Oversized Black	0
COL name VAL L'OrÃ©al Paris True Match BakÄ±m Yapan FondÃ¶ten 0.5R Rose PorcelaÄ±n	COL name VAL L'oreal paris L'OrÃ©al Paris True Match BakÄ±m Yapan FondÃ¶ten 5R ROSE SAND	0
COL name VAL L'oreal paris True Match BakÄ±m Yapan FondÃ¶ten 1D GOLDEN IVORY	COL name VAL L'orÃ©al Paris True Match BakÄ±m Yapan FondÃ¶ten 1r Rose Ivory	0
COL name VAL L'OrÃ©al Paris True Match BakÄ±m Yapan FondÃ¶ten 1R ROSE IVORY	COL name VAL L'oreal paris True Match BakÄ±m Yapan FondÃ¶ten 1R ROSE IVORY	0
COL name VAL Loreal Paris L'orÃ©al Paris Telescopic Carbon Black Maskara, Siyah, 8 ml	COL name VAL L'oreal paris Telescopic Carbon Extra Black Maskara - Siyah	0
COL name VAL L'OrÃ©al Paris Infaillible Shaping Stick FondÃ¶ten 130 Vanilla	COL name VAL L'oreal paris Stick FondÃ¶ten - Infaillible Shaping Stick FondÃ¶ten 130 Vanilla	1
COL name VAL L'oreal paris Loreal True Match Foundation 5d Golden Sand FondÃ¶ten SÃ¼ngeri Seti	COL name VAL L'OrÃ©al Paris True Match BakÄ±m Yapan FondÃ¶ten - 5D Golden Sand	1
COL name VAL L'OrÃ©al Paris Infaillible Metallic Eye Paint 401 Metallic Copper	COL name VAL L'oreal paris GÃ¶z FarÄ± - Infallible Paint Eyeshadow 401 Metal Copp	1
COL name VAL L'oreal paris Brow Artist Plump&set Renkli KaÅŸ Sabitleyici Maskara - 108 Dark Brunette	COL name VAL L'Oreal Paris Brow Artist Plump & Set Dolgun GÃ¶rÃ¼nÃ¼m Veren KaÅŸ Sa	1
COL name VAL L'OrÃ©al Paris Cr. Khol Kajal 138 Blue	COL name VAL L'Oreal Paris GÃ¶z Kalemi No 107 Kot Mavisi	1
COL name VAL L'oreal paris L'orÃ©al Paris True Match BakÄ±m Yapan FondÃ¶ten 7r Rose Amber	COL name VAL L'orÃ©al Paris True Match BakÄ±m Yapan FondÃ¶ten 1r Rose Ivory	0
COL name VAL L'oreal paris Kahverengi Eyeliner - Infaillible Gel Crayon Eyeliner 05 Cooper	COL name VAL L'OrÃ©al Paris Infaillible Gel Crayon GÃ¶z Kalemi 05 Super Cooper - BakÄ±r	1
COL name VAL Loreal Paris FondÃ¶ten No 130 Visible Lift	COL name VAL L'oreal paris Visible Lift Serum InsÄ±de Mat 100	1
COL name VAL Loreal Paris Lâ€™orÃ©al Paris Uzun SÃ¼re KalÄ±cÄ± KaÅŸ Jeli Unbelieva Brow - 109 Ebony	COL name VAL L'oreal paris L'orÃ©al Paris Unbelieva Brow Uzun SÃ¼re KalÄ±cÄ± KaÅŸ Jeli - 109 Ebony	1
COL name VAL L'oreal paris True Match BakÄ±m Yapan FondÃ¶ten 2N VANILLA	COL name VAL Loreal Paris True Match FondÃ¶ten 2n Vanilla	0
COL name VAL L'OrÃ©al Paris Superliner Perfect Slim Siyah Eyeliner	COL name VAL L'oreal paris Superliner Perfect Slim Siyah Eyeliner -	1
COL name VAL L'orÃ©al Paris Bambi Eye Oversized Ceylan GÃ¶z Etkili Maskara - Siyah	COL name VAL L'oreal paris L'orÃ©al Paris Bambi Eye Oversized Ceylan GÃ¶z Etkili Maskara - Siyah	1
COL name VAL L'oreal paris Telescopic Gold Siyah Maskara & Infaillible 24h Fresh Wear Pudra FondÃ¶ten 40 Cashmere	COL name VAL Loreal Paris Telescopic Gold Siyah Maskara & Infaillible 24H Fresh Wear Pudra FondÃ¶ten 120 Vanilla	0
COL name VAL L'oreal paris Dore TonlarÄ±nda AydÄ±nlatÄ±cÄ± - True Match Highlight 101D / 101W Golden Glow	COL name VAL L'OrÃ©al Paris True Match Highlight AydÄ±nlatÄ±cÄ± 101D/101W Dore	1
COL name VAL L'oreal Paris True Match BakÄ±m Yapan FondÃ¶ten 5n Sand FondÃ¶ten	COL name VAL L'oreal paris True Match BakÄ±m Yapan FondÃ¶ten 1.5 LINEN	0
COL name VAL L'oreal paris Infaillible 24h Matte FondÃ¶ten 24 BeÄ±ge Dore	COL name VAL L'OrÃ©al Paris Infaillible 24H Matte FondÃ¶ten 24 BEIGE DORE	1
COL name VAL Loreal Paris Loreal True Match Nude Serum FondÃ¶ten Very Light FondÃ¶ten FÄ±rÃ§asÄ± Seti	COL name VAL L'oreal paris Loreal True Match Nude Serum FondÃ¶ten Very Light FondÃ¶ten FÄ±rÃ§asÄ± Seti	0
COL name VAL L'OrÃ©al Paris Infaillible 24H FondÃ¶ten 140 GOLDEN BEIGE	COL name VAL L'oreal paris L'OrÃ©al Paris Infaillible 32H Fresh Wear C Vitaminli FondÃ¶ten - 140 Golden Beige	1
COL name VAL L'OrÃ©al Paris Paradise Suya DayanÄ±klÄ± Siyah Maskara	COL name VAL L'OrÃ©al Paris Paradise Suya DayanÄ±klÄ± Siyah Maskara	1
COL name VAL Loreal Paris L'orÃ©al Paris Air Volume Mega Hacim Veren Maskara - Siyah	COL name VAL L'oreal paris Loreal Air Volume Mega Hacim Veren Maskara Siyah	1
COL name VAL L'OrÃ©al Paris Color Riche Shine Naked Tans Ruj 659 Blow Your Glow - Nude	COL name VAL L'oreal paris Color Riche Shine Naked Tans Ruj 658 Topless - Nude	1
COL name VAL L'oreal paris Likit Mat Ruj - Les Chocolats Ultra Matte Liquid Lipstick 842 Candy Man	COL name VAL L'Oreal Paris Les Chocolats Ultra Matte Likit Ruj 842 Candy Man	1
COL name VAL Loreal Paris L'orÃ©al Paris Unbelieva Brow Uzun SÃ¼re KalÄ±cÄ± Åžeffaf KaÅŸ MaskarasÄ±	COL name VAL L'oreal paris Unbelieva Brow Uzun SÃ¼re KalÄ±cÄ± Åžeffaf KaÅŸ MaskarasÄ±	0
COL name VAL L'oreal paris True Match BakÄ±m Yapan FondÃ¶ten 1N IVORY	COL name VAL L'orÃ©al Paris True Match BakÄ±m Yapan FondÃ¶ten 1r Rose Ivory	0
COL name VAL Loreal Paris Superliner Smokissime Eyeliner	COL name VAL L'OrÃ©al Paris Superliner Smokissime Eyeliner BLACK	1
COL name VAL L'OrÃ©al Paris True Match BakÄ±m Yapan FondÃ¶ten 4D GOLDEN NATURAL	COL name VAL L'oreal paris L'orÃ©al Paris True Match BakÄ±m Yapan FondÃ¶ten 7d Golden Amber	0
COL name VAL L'Oreal Paris Super LÄ±ner Black Lacquer Waterproof Eyeliner	COL name VAL L'oreal paris Suya DayanÄ±klÄ± Siyah Eyeliner - Super Liner Black Lacquer Waterproof Eyeliner 6 ml	1
COL name VAL L'OrÃ©al Paris Le Liner Signature GÃ¶z Kalemi 04 Gold Velvet	COL name VAL L'oreal paris Le Liner Signature GÃ¶z Kalemi 04 Gold Velvet	1
COL name VAL L'oreal paris Uzun SÃ¼re KalÄ±cÄ± FondÃ¶ten - Infallible 24H Foundation 145 Beige Rose	COL name VAL L'OrÃ©al Paris Infaillible 24H FondÃ¶ten 145 BEIGE ROSE	1
COL name VAL L'oreal paris Mat Eyeliner - Matte Signature Eyeliner 02 Blue 30175235	COL name VAL L'OrÃ©al Paris Matte Signature Eyeliner 02 Blue - Mavi	1
COL name VAL L'oreal paris True Match BakÄ±m Yapan FondÃ¶ten 1R ROSE IVORY	COL name VAL L'orÃ©al Paris True Match BakÄ±m Yapan FondÃ¶ten 1r Rose Ivory	0
COL name VAL L'oreal paris AydÄ±nlatÄ±cÄ± Paleti 02 Cool Glow+lionesse Barbie Makyaj FÄ±rÃ§asÄ± 010	COL name VAL Loreal Paris AydÄ±nlatÄ±cÄ± Paleti 02 Cool Glow+Lionesse Barbie Makyaj FÄ±rÃ§asÄ± 010	0
COL name VAL L'OrÃ©al Paris True Match KapatÄ±cÄ± 6D/W Golden Honey	COL name VAL L'oreal paris KapatÄ±cÄ± - True Match Concealer Golden Honey	1
COL name VAL Loreal Paris Ruj LÄ±p PaÄ±nt Matte 207 Wuthering Purple	COL name VAL Loreal botanicals Loreal Paris Ruj LÄ±p PaÄ±nt Matte 207 Wuthering Purple	0
COL name VAL L'Oreal Paris Les Chocolats Likit Mat Ruj 862 Volupto Choco	COL name VAL L'OrÃ©al Paris Les Chocolats Likit Mat Ruj 862 Volupto Choco	1
COL name VAL L'OrÃ©al Paris Eye Go Wild Paleti	COL name VAL L'oreal paris Eye Go Wild GÃ¶z FarÄ± Paleti	1
COL name VAL L'oreal paris Mat Ruj - Color Riche Matte Addiction Lipstick 347 Rouge Stiletto	COL name VAL L'OrÃ©al Paris Color Riche Matte Addiction Ruj 347 Haute Rouge - KÄ±rmÄ±zÄ±	1
COL name VAL L'OrÃ©al Paris True Match BakÄ±m Yapan FondÃ¶ten 3D GOLDEN BEIGE	COL name VAL L'oreal paris True Match BakÄ±m Yapan FondÃ¶ten 3D GOLDEN BEIGE	1
COL name VAL L'Oreal Paris GÃ¶z Kalemi No 107 Kot Mavisi	COL name VAL L'oreal paris Lacivert GÃ¶z Kalemi - Contour Khol Kajal 138 Blue Denim	1
COL name VAL L'OrÃ©al Paris Infaillible Lip Paint Likit Ruj Matte 201 Hollywood Beige- Nude	COL name VAL L'oreal paris Likit Mat Ruj - Infaillible Lip Paint Matte 201 Hollywood Beige X 2 Adet	0
COL name VAL L'OrÃ©al Paris True Match BakÄ±m Yapan FondÃ¶ten 1D Golden Ivory	COL name VAL L'oreal paris True Match BakÄ±m Yapan FondÃ¶ten 1D GOLDEN IVORY	1
COL name VAL L'oreal paris Telescopic Yeni Siyah Maskara	COL name VAL L'orÃ©al Paris Telescopic Maskara - Siyah 2'li	0
COL name VAL L'Oreal Paris Les Macarons Ultra Matte Liquid Lipstick Ruj 820 Pral	COL name VAL L'oreal paris Likit Mat Ruj - Les Macarons Ultra Matte Liquid Lipstick 820 Praline De	1
COL name VAL Loreal Paris Le Liner Signature GÃ¶z Kalemi 08 Taupe Grey Tweed	COL name VAL Loreal Paris Le Liner Signature GÃ¶z Kalemi 08 Taupe Grey Tweed	1
COL name VAL L'oreal paris Bambi Eye Extra Black Ceylan GÃ¶z Etkili Maskara Ekstra Siyah 30178564	COL name VAL Loreal Paris L'oreal Paris Bambi Eye Ceylan GÃ¶z Etkili Maskara Eks. Siyah Maskara	0
COL name VAL L'OrÃ©al Paris Color Riche Plump & Shine Ruj 101 Nectarine Plump	COL name VAL L'oreal paris Color Riche Plump & Shine Ruj 101 Nectarine Plump	1
COL name VAL L'oreal paris Likit Mat Ruj - Infaillible Lip Paint Matte 201 Hollywood Beige	COL name VAL L'OrÃ©al Paris Infaillible Lip Paint Likit Ruj Matte 201 Hollywood Beige- Nude	1
COL name VAL L'oreal paris Ruj - Color Riche Shine Naked Tans 659 Blow Your Glow - Nude	COL name VAL L'OrÃ©al Paris Color Riche Shine Naked Tans Ruj 659 Blow Your Glow - Nude	1
COL name VAL L'OrÃ©al Paris Color Riche La Palette Nude Far Paleti BEIGE	COL name VAL L'oreal paris GÃ¶z FarÄ± Paleti - La Palette Nude 002 Beige	1
COL name VAL L'Oreal Paris Les Chocolats Likit Mat Ruj 852 Box Of Chocolates	COL name VAL L'OrÃ©al Paris Les Chocolats Likit Mat Ruj 852 Box Of Chocolates	1
COL name VAL L'OrÃ©al Paris Infaillible Shaping Stick FondÃ¶ten 140 Natural Rose	COL name VAL L'oreal paris Stick FondÃ¶ten - Infaillible Shaping Stick FondÃ¶ten 140 Natural Rose	1
COL name VAL L'OrÃ©al Paris True Match BakÄ±m Yapan FondÃ¶ten 7R ROSE AMBER	COL name VAL L'oreal paris True Match BakÄ±m Yapan FondÃ¶ten 2r Rose	0
COL name VAL L'OrÃ©al Paris Bronze Please! BronzlaÅŸtÄ±rÄ±cÄ± Pudra 03 Amalfi Medio	COL name VAL L'oreal paris Bronze Please! BronzlaÅŸtÄ±rÄ±cÄ± Pudra 03 Amalfi	1
COL name VAL L'OrÃ©al Paris True Match BakÄ±m Yapan FondÃ¶ten 4.5N True BeÄ±ge	COL name VAL L'oreal paris L'OrÃ©al Paris True Match BakÄ±m Yapan FondÃ¶ten 1.5 Linen	0
COL name VAL L'oreal paris L'orÃ©al Paris True Match BakÄ±m Yapan FondÃ¶ten 4n BeÄ±ge	COL name VAL L'Oreal  Paris True Match BakÄ±m Yapan FondÃ¶ten 4N Beige	1
COL name VAL L'Oreal Paris Color Richa Ultra Matte Mat Ruj No Doubts	COL name VAL L'OrÃ©al Paris Color Riche Free The Nudes Ruj - No Diktat	1
COL name VAL L'OrÃ©al Paris Concealer Lumimagic Dark	COL name VAL L'oreal paris KapatÄ±cÄ± & AydÄ±nlatÄ±cÄ± - Lumimagic Highlighter Pen 03 Dark	1
COL name VAL L'oreal paris Infaillible 24H Matte Cover YÃ¼ksek KapatÄ±cÄ± FondÃ¶ten 290 Golden Amber	COL name VAL Loreal Paris Loreal FondÃ¶ten Paris Infaillible 24H Matte Cover YÃ¼ksek KapatÄ±cÄ± FondÃ¶ten No: 290 Golden Amber	0
COL name VAL L'OrÃ©al Paris Infaillible Dudak Kalemi 213 Stripped Brown- Kahverengi	COL name VAL L'oreal paris Dudak Kalemi - Infaillible Lip Pencil 213 Stripped Brown	1
COL name VAL L'oreal paris Likit Mat Ruj - Rouge Signature 105 Rule	COL name VAL L'Oreal Paris Rouge Signature Likit Mat Ruj 105 Rule	1
COL name VAL L'OrÃ©al Paris True Match KapatÄ±cÄ± 6D/W Golden Honey	COL name VAL L'oreal paris KapatÄ±cÄ± - True Match Concealer Golden Honey	1
COL name VAL L'Oreal Paris Rouge Signature Matte Likit Ruj 104 Rebel	COL name VAL L'oreal paris Likit Mat Ruj - Rouge Signature 104 Rebel	1
COL name VAL Loreal botanicals Loreal Infallible Longwear Shaping Stick 501	COL name VAL Loreal Infallible Longwear Shaping Stick 502	0
COL name VAL L'OrÃ©al Paris Color Riche Matte Addiction Ruj 908 Storm - Gri/Lila	COL name VAL L'oreal paris Mat Ruj - Color Riche Matte Addiction 908 Storm	1
COL name VAL L'oreal paris Infaillible 24h Fresh Wear Pudra FondÃ¶ten 140 Golden Beige	COL name VAL Infaillible 24H Fresh Wear Pudra FondÃ¶ten 140 Golden Beige	1
COL name VAL L'OrÃ©al Paris True Match BakÄ±m Yapan FondÃ¶ten 1N Ivory	COL name VAL L'oreal paris True Match BakÄ±m Yapan FondÃ¶ten 1N IVORY	1
COL name VAL Loreal Paris Lâ€™orÃ©al Paris Uzun SÃ¼re KalÄ±cÄ± KaÅŸ Jeli Unbelieva Brow - 109 Ebony	COL name VAL L'oreal paris Unbelieva Brow Uzun SÃ¼re KalÄ±cÄ± KaÅŸ Jeli -105 Brunette	0
COL name VAL L'oreal paris Emotions Of Nu AllÄ±k & Far Paleti EmotÄ±ons Nude	COL name VAL Loreal Paris L'oreal Paris Emotions Of Nu AllÄ±k Ve Far Paleti GÃ¶z FarÄ±	0
COL name VAL Loreal Paris Unlimited Siyah Maskara 2'li Set	COL name VAL L'oreal paris Unlimited Siyah Maskara 2'li Set + Ayna	0
COL name VAL L'oreal paris Loreal Telescopic Maskara GÃ¶z Makyaj Seti	COL name VAL Loreal Paris Telescopic Maskara GÃ¶z Makyaj Seti	0
COL name VAL L'oreal paris Unbelieva Brow Uzun SÃ¼re KalÄ±cÄ± KaÅŸ Jeli -105 Brunette	COL name VAL Loreal Paris Lâ€™orÃ©al Paris Uzun SÃ¼re KalÄ±cÄ± KaÅŸ Jeli Unbelieva Brow - 108 Dark Brunette	0
COL name VAL L'oreal paris Kahverengi Les Chocolats Ultra Matte Liquid Lipstick 860 Likit Mat Ruj	COL name VAL L'OrÃ©al Paris Les Chocolats Likit Mat Ruj 860 Ginger Bomb	1
COL name VAL L'OrÃ©al Paris Infaillible TÃ¼m YÃ¼ze Uygulanabilir KapatÄ±cÄ± 322 Ivory	COL name VAL L'oreal paris Infaillible TÃ¼m YÃ¼ze Uygulanabilir KapatÄ±cÄ± 327 Cashmere	0
COL name VAL Loreal Paris Loreal FondÃ¶ten Paris Infaillible 24H Matte Cover YÃ¼ksek KapatÄ±cÄ± FondÃ¶ten No: 290 Golden Amber	COL name VAL L'oreal paris Infaillible 24H Matte Cover YÃ¼ksek KapatÄ±cÄ± FondÃ¶ten 290 Golden Amber	0
COL name VAL Loreal Paris L'orÃ©al Paris Bambi Eye Extra Black Ceylan GÃ¶z Etkili Maskara - Ekstra Siyah	COL name VAL L'oreal paris Bambi Eye Ceylan GÃ¶z Etkili Maskara  Siyah	0
COL name VAL L'OrÃ©al Paris Infaillible 24H FondÃ¶ten 130 TRUE BEIGE	COL name VAL L'oreal paris Uzun SÃ¼re KalÄ±cÄ± FondÃ¶ten - Infaillible 24h Fresh Wear 130 True Beige 30 ml	1
COL name VAL L'oreal paris Volume Million Lashes Feline Noir Black Maskara 9.2 ml	COL name VAL Loreal Paris Volume Million Lashes Fatale Noir Black Maskara 9.4 ml	0
COL name VAL L'oreal paris Rouge Signature Parisian Sunset Likit Mat Ruj 132radiate	COL name VAL L'OrÃ©al Paris Rouge Signature Parisian Sunset Likit Mat Ruj - 132 I Radiate	0
COL name VAL L'OrÃ©al Paris Color Riche Ruj Exclusive Reds FREIDA'S PURE RED	COL name VAL L'oreal paris Ruj - Color Riche Exclusive Reds - Freida's Red	1
COL name VAL L'oreal paris L'orÃ©al Paris Glow Paradise Balm-in-lipstick - IÅŸÄ±ltÄ± Veren Ruj 642 Beige Eden	COL name VAL L'OrÃ©al Paris Color Riche Shine Ruj 642 MLBB - Nude	1
COL name VAL L'OrÃ©al Paris Back To Bronze Mat BronzlaÅŸtÄ±rÄ±cÄ± Pudra	COL name VAL L'oreal paris AllÄ±k - Skin Awakening Blush 02 Back To Bronze	1
COL name VAL Loreal Paris True Match Nude Serum FondÃ¶ten 2-3 Light	COL name VAL L'oreal paris L'orÃ©al Paris True Match Nude FondÃ¶ten Serum 3-4 Light Medium	0
COL name VAL L'oreal paris Ruj - Color Riche Shine Addiction Lipstick 352 YOLO	COL name VAL L'OrÃ©al Paris Color Riche Shine Ruj 352 Y.O.L.O - KÄ±rmÄ±zÄ±	1
COL name VAL L'OrÃ©al Paris Paradise Orman Meyvesi Kokulu Mor Maskara	COL name VAL L'oreal paris Paradise Orman Meyvesi Kokulu Mor Maskara 02	1
COL name VAL L'Oreal Paris Caresse Lipstick Ruj 202	COL name VAL L'OrÃ©al Paris Rouge Caresse 202 Impulsive Fuchsia Ruj	1
COL name VAL Loreal Paris Volume Millions De Cils Siyah Maskara	COL name VAL L'oreal paris Volume Millions De Cils Siyah Maskara	1
COL name VAL L'oreal Paris True Match BakÄ±m Yapan FondÃ¶ten 5n Sand FondÃ¶ten	COL name VAL L'oreal paris True Match BakÄ±m Yapan FondÃ¶ten 1N IVORY	0
COL name VAL L'oreal paris L'orÃ©al Paris Kusursuz Makyaj Temizleme Suyu Hassas 400 ml	COL name VAL L'OrÃ©al Paris Micellar Kusursuz Makyaj Temizleme Suyu Hassas 400ML	0
COL name VAL L'OrÃ©al Paris Infaillible Dudak Kalemi 701 Stay Ultraviolet- Pembe	COL name VAL L'oreal paris Dudak Kalemi  Infaillible Lip Pencil 701 Stay Ultraviolet	1
COL name VAL L'oreal paris C'Ã©st Magic BB Krem 03 Medium Light	COL name VAL L'OrÃ©al Paris C'Ã‰st Magic Bb Krem 03 Medium Light	1
COL name VAL Marka: L'oreal Paris Mat Eyeliner - Matte Signature Eyeliner 05 Burgundy 30175266 Kategori: Eyeline	COL name VAL L'oreal paris Mat Eyeliner - Matte Signature Eyeliner 05 Burgundy 30175266	0
COL name VAL L'oreal paris Siyah Maskara Bambi Eye Oversized Black	COL name VAL L'OrÃ©al Paris Bambi Oversized Eye Siyah Maskara + Ayna	0
COL name VAL L'oreal paris L'orÃ©al Paris True Match Nude FondÃ¶ten Serum 0.5-2 Very Light	COL name VAL Loreal Paris True Match Nude Serum FondÃ¶ten 2-3 Light	0
COL name VAL L'oreal paris Dudak Kalemi - Infaillible Lip Pencil 701 Stay Ultraviolet	COL name VAL L'OrÃ©al Paris Infallible Stay Ultraviolet 701 Dudak Kalemi	0
COL name VAL L'oreal paris True Match BakÄ±m Yapan FondÃ¶ten 2R Rose Vanilla+True Match KapatÄ±cÄ± 2N Vanilla	COL name VAL Loreal Paris L'oreal Paris True Match BakÄ±m Yapan FondÃ¶ten 2r Rose Vanilla+True Match KapatÄ±cÄ± 2r/c Rose Vanilla	0
COL name VAL L'oreal paris Color Queen GÃ¶z Far 21	COL name VAL L'OrÃ©al Paris Color Queen Tekli GÃ¶z FarÄ± 21 Almighty	1
COL name VAL L'OrÃ©al Paris True Match BakÄ±m Yapan FondÃ¶ten 1D GOLDEN IVORY	COL name VAL L'Oreal Paris True Match BakÄ±m Yapan FondÃ¶ten 1d Golden Ivory	1
COL name VAL L'oreal paris Emotions of Nu AllÄ±k & Far Paleti	COL name VAL Loreal Paris L'oreal Paris Emotions Of Nu AllÄ±k Ve Far Paleti GÃ¶z FarÄ±	0
COL name VAL L'oreal paris L'orÃ©al Volumissime Royale X10 Maskara Siyah 2 Adet Set	COL name VAL L'OrÃ©al Paris Volumissime Royale X10 Siyah Maskara	0
COL name VAL L'OrÃ©al Paris Superstar XFiber Siyah Maskara	COL name VAL L'oreal paris Siyah False Lash Superstar X Fiber Maskara 01 	1
COL name VAL L'oreal paris Mavi Eyeliner - Infaillible Gel Crayon Eyeliner 10 Blue	COL name VAL L'OrÃ©al Paris Infaillible Gel Crayon GÃ¶z Kalemi 10 I've Got the Blue - Mavi	1
COL name VAL L'OrÃ©al Paris Rouge Signature Lip Topper Dudak ParlatÄ±cÄ± Ruj - 210 White Gold	COL name VAL L'oreal paris ParlatÄ±cÄ± Ruj - Rouge Signature Lip Topper 210 White Gold	1
COL name VAL L'OrÃ©al Paris Cr. Khol Kajal 138 Blue	COL name VAL L'oreal paris Lacivert GÃ¶z Kalemi - Contour Khol Kajal 138 Blue Denim	1
COL name VAL L'OrÃ©al Paris True Match KapatÄ±cÄ± 3R/C Rose Beige	COL name VAL L'oreal paris KapatÄ±cÄ± - True Match Concealer 3r/c Rose Beige	1
COL name VAL L'oreal paris Likit Mat Ruj - Les Chocolats Ultra Matte Liquid Lipstick 842 Candy Man	COL name VAL L'OrÃ©al Paris Les Chocolats Likit Mat Ruj 842 Candy Man	1
COL name VAL L'OrÃ©al Paris Infaillible 24H Matte Cover YÃ¼ksek KapatÄ±cÄ± FondÃ¶ten - 175 Sable/Sand	COL name VAL L'oreal paris Infaillible 24h Matte Cover YÃ¼ksek KapatÄ±cÄ± FondÃ¶ten 175 Sable/sand	1
COL name VAL L'OrÃ©al Paris Infaillible TÃ¼m YÃ¼ze Uygulanabilir KapatÄ±cÄ± 338 Honey	COL name VAL L'oreal paris L'OrÃ©al Paris Infaillible 24H TÃ¼m YÃ¼ze Uygulanabilir KapatÄ±cÄ± - 330 Pecan	0
COL name VAL L'oreal paris Infaillible 24h Ruj 506 Red - KÄ±rmÄ±zÄ±	COL name VAL L'OrÃ©al Paris Infaillible 24H Ruj 506 RED INFAILLIBLE	0
COL name VAL Loreal Infallible Longwear Shaping Stick 502	COL name VAL Loreal botanicals Loreal Infallible Longwear Shaping Stick 503	0
COL name VAL Loreal Paris Brow Artist Plump &amp; Set Dolgun GÃ¶rÃ¼nÃ¼m Veren KaÅŸ Sabitleyici Maskara - 101 Blonde	COL name VAL L'oreal paris L'OrÃ©al Paris Brow Artist Plump & Set Dolgun GÃ¶rÃ¼nÃ¼m Veren KaÅŸ Sabitleyici Maskara  - 101 Blonde	1
COL name VAL L'OrÃ©al Paris Infaillible Dudak Kalemi 105 Red Fiction- KÄ±rmÄ±zÄ±	COL name VAL L'oreal paris Dudak Kalemi - Infaillible Lip Pencil 105 Red Fiction	1
COL name VAL L'OrÃ©al Paris Infaillible Nudist Eye Paint 205-COCKY BISQUE	COL name VAL L'oreal paris GÃ¶z FarÄ± - Infaillible Paint Nude Eyeshadow 205 Champagne	1
COL name VAL L'oreal paris Ruj - Color Riche Lipstick 238 Orange After	COL name VAL L'Oreal Paris Ruj No: 238	1
COL name VAL L'OrÃ©al Paris Infaillible Eye Paint GÃ¶z FarÄ± 102 Irresistible Rose	COL name VAL L'oreal paris GÃ¶z FarÄ± - Infallible Eyeshadow Paint 102 Irresistible	1
COL name VAL Loreal Paris HÄ±ghlÄ±ghter Glow Mon Amour 05 Glow De Coco	COL name VAL L'oreal paris Glow Mon Amour 05 Glow De Coco Likit AydÄ±nlatÄ±cÄ±  Highlighter 15 ml	1
COL name VAL L'OrÃ©al Paris Infaillible AydÄ±nlatÄ±cÄ± Makyaj BazÄ±	COL name VAL L'oreal paris AydÄ±nlatÄ±cÄ± Makyaj BazÄ± - Infaillible Luminizing Primer	1
COL name VAL L'oreal paris Loreal True Match Nude Serum FondÃ¶ten Very Light FondÃ¶ten FÄ±rÃ§asÄ± Seti	COL name VAL Loreal Paris Loreal True Match Nude Serum FondÃ¶ten Light FondÃ¶ten FÄ±rÃ§asÄ±	0
COL name VAL L'OrÃ©al Paris Glow Mon Amour Likit AydÄ±nlatÄ±cÄ± 03 Bronze In Love	COL name VAL L'oreal paris Likit AydÄ±nlatÄ±cÄ± - Glow Mon Amour Droplet Highlight 03 Bronze In Love	1
COL name VAL L'oreal paris Infaillible 24h Matte Cover YÃ¼ksek KapatÄ±cÄ± FondÃ¶ten 115 Golden Beige	COL name VAL L'OrÃ©al Paris Infaillible 24H Matte Cover YÃ¼ksek KapatÄ±cÄ± FondÃ¶ten - 130 True Beige	0
COL name VAL L'oreal paris Telescopic Siyah Maskara 2'li Set	COL name VAL Loreal Paris L'orÃ©al Paris Telescopic Maskara - Siyah 1 Paket	0
COL name VAL L'OrÃ©al Paris Rouge Signature Likit Mat Ruj - 103 I Enjoy	COL name VAL L'Oreal Paris Rouge Signature Matte Likit Ruj 113 Enjoy	1
COL name VAL L'oreal paris Ruj - Infallible Mega Gloss 503 All Night Long	COL name VAL L'OrÃ©al Paris Mega Gloss Lip Gloss 503 ALL NIGHT LONG	1
COL name VAL L'Oreal Paris Infaillible 24H Matte Cover YÃ¼ksek KapatÄ±cÄ± FondÃ¶ten	COL name VAL L'oreal paris Infaillible 24H Matte Cover YÃ¼ksek KapatÄ±cÄ± FondÃ¶ten 135 Radiant Vanilla	1
COL name VAL L'OrÃ©al Paris Infaillible Sculpt Palette KontÃ¼r Paleti 03 MEDIUM DARK	COL name VAL L'oreal paris KontÃ¼r Paleti - Infallible Sculpt Contouring Palette 02 Medium/Light	1
COL name VAL L'OrÃ©al Paris True Match BakÄ±m Yapan FondÃ¶ten 9N Truffe	COL name VAL L'oreal paris L'orÃ©al Paris True Match BakÄ±m Yapan FondÃ¶ten 5n Sand	0
COL name VAL L'OrÃ©al Paris Infaillible TÃ¼m YÃ¼ze Uygulanabilir KapatÄ±cÄ± 334 Walnut	COL name VAL L'oreal paris L'OrÃ©al Paris Infaillible TÃ¼m YÃ¼ze Uygulanabilir KapatÄ±cÄ± 338 Honey	0
COL name VAL Loreal Paris L'orÃ©al Paris Bambi Eye Ceylan GÃ¶z Etkili Maskara, Siyah, 8.9 ml	COL name VAL L'oreal paris Siyah Bambi Eye Oversized Ceylan GÃ¶z Etkili Maskara	0
COL name VAL L'OrÃ©al Paris Color Riche Free The Nudes Ruj - No Doubts	COL name VAL L'oreal paris Ruj - Color Riche Free The Nudes 03 No Doubts	1
COL name VAL L'oreal paris KadÄ±n 163 Orange Magique Ruj	COL name VAL Loreal Paris Loreal Color Riche Lipstick 163 Orange Magique	1
COL name VAL L'oreal paris L'orÃ©al Paris True Match BakÄ±m Yapan FondÃ¶ten 5d Golden Sand	COL name VAL L'OrÃ©al Paris True Match BakÄ±m Yapan FondÃ¶ten - 5D Golden Sand	1
COL name VAL L'OrÃ©al Paris Brow Artist High Contour 107 Cool Brunette - Koyu Kumral	COL name VAL L'oreal paris KaÅŸ Kalemi - Brow Artist High Contour 107 Cool Brown	1
COL name VAL L'oreal paris L'OrÃ©al Paris Infaillible 32H Fresh Wear C Vitaminli FondÃ¶ten - 145 Rose Beige	COL name VAL L'OrÃ©al Paris Infaillible 24H FondÃ¶ten 145 ROSE BEIGE	1
COL name VAL Loreal Paris L'orÃ©al Paris Bambi Eye Ceylan GÃ¶z Etkili Maskara, Siyah, 8.9 ml	COL name VAL L'oreal paris Bambi Eye Ceylan GÃ¶z Etkili Maskara  Siyah	0
COL name VAL L'OrÃ©al Paris Infaillible Shaping Stick FondÃ¶ten 220 Caramel	COL name VAL L'oreal paris Stick FondÃ¶ten Infaillible Longwear Shaping Stick Foundation 220 Caramel 9 gr	1
COL name VAL L'oreal paris Ruj - Color Riche Free The Nudes 06 No Hesitation	COL name VAL L'Oreal Paris Color Richa Ultra Matte Mat Ruj No Doubts	1
COL name VAL L'OrÃ©al Paris True Match Nude FondÃ¶ten Serum 3-4 Light Medium	COL name VAL L'oreal paris L'orÃ©al Paris True Match Nude FondÃ¶ten Serum 3-4 Light Medium	1
COL name VAL L'orÃ©al Paris Bambi Eye Oversized Ceylan GÃ¶z Etkili Maskara - Siyah	COL name VAL L'oreal paris Siyah Bambi Eye Oversized Ceylan GÃ¶z Etkili Maskara	1
COL name VAL L'OrÃ©al Paris True Match KapatÄ±cÄ± - 4N Beige	COL name VAL L'oreal paris KapatÄ±cÄ± - True Match Concealer 4n Beige	1
COL name VAL Loreal Paris L'oreal Paris Micellar Makyaj Temizleme Suyu Normalden Kuruya Hassas Ciltler IÃ§in 200 ml	COL name VAL L'oreal paris Normal & Karma Ve Hassas Ciltler IÃ§in Micellar Kusursuz Makyaj Temizleme Suyu 400 Ml	0
COL name VAL L'oreal paris True Match Foundation 2r Rose Vanilla 30 ml	COL name VAL L'OrÃ©al Paris True Match BakÄ±m Yapan FondÃ¶ten 2R ROSE VANILLA	1
COL name VAL L'oreal paris Siyah Smokissime Superliner 100 Black	COL name VAL Loreal Paris Superliner Smokissime Eyeliner	1
COL name VAL L'OrÃ©al Paris Rouge Signature Parisian Sunset Likit Mat Ruj - 121 I Choose	COL name VAL L'oreal paris Rouge Signature Parisian Sunset Likit Mat Ruj 121Choose	1
COL name VAL L'oreal paris BB Krem AÃ§Ä±k Ton - Skin Perfection BB Cream Light Spf 25 50ml	COL name VAL L'OrÃ©al Paris Skin Perfection Cilt KusursuzlaÅŸtÄ±rÄ±cÄ± 5'I 1 Arada BB Krem AÃ§Ä±k Ton	1
COL name VAL L'Oreal Paris True Match BakÄ±m Yapan FondÃ¶ten 1.5 LÄ±nen	COL name VAL L'oreal paris True Match BakÄ±m Yapan FondÃ¶ten 1.5 LÄ±nen	1
COL name VAL Loreal botanicals Loreal Infallible Longwear Shaping Stick 501	COL name VAL Loreal Infallible Longwear Shaping Stick 501	0
COL name VAL L'oreal paris Likit Kompakt FondÃ¶ten - Nude Magique Liquid Cushion Foundation 04 Rose Vanilla	COL name VAL L'OrÃ©al Paris Nude Magique Cushion FondÃ¶ten 04 ROSE VANILLA	1
COL name VAL L'oreal paris Infaillible 24h Matte Cover YÃ¼ksek KapatÄ±cÄ± FondÃ¶ten 115 Golden Beige	COL name VAL L'OrÃ©al Paris Infaillible 24H Matte Cover YÃ¼ksek KapatÄ±cÄ± FondÃ¶ten - 200 Golden Sand	0
COL name VAL L'OrÃ©al Paris Makyaj FÄ±rÃ§asÄ±-AllÄ±k FÄ±rÃ§asÄ±	COL name VAL L'oreal paris L'orÃ©al Paris Makyaj AllÄ±k FÄ±rÃ§asÄ±	1
COL name VAL L'oreal paris KontÃ¼r Paleti - Infallible Sculpt Contouring Palette 02 Medium/Light	COL name VAL L'OrÃ©al Paris Infaillible Sculpt Palette KontÃ¼r Paleti 02 MEDIUM LIGHT	1
COL name VAL Loreal Paris KaÅŸ Serumu Brow AsÄ±st Plumo & Set 108 Dark Brunette	COL name VAL L'oreal paris Brow Artist Plump&set Renkli KaÅŸ Sabitleyici Maskara - 108	1
COL name VAL L'oreal paris BB Krem - Bonjour Nudista BB Cream 04 Medium Dark	COL name VAL L'OrÃ©al Paris Bonjour Nudista AydÄ±nlÄ±k Veren Renkli Nemlendirici 04 Medium Dark - Koyu Ton	1
COL name VAL L'OrÃ©al Paris Color Riche Free The Nudes Ruj - No Obstacles	COL name VAL L'oreal paris Ruj - Color Riche Free The Nudes 01 No Obstacles	1
COL name VAL L'oreal paris Ruj - Infallible Mega Gloss 102 Scream And Shout	COL name VAL L'OrÃ©al Paris Mega Gloss Lip Gloss 102 SCREAM AND SHOUT	1
COL name VAL L'oreal paris AÃ§Ä±k Kahverengi KaÅŸ Kalemi - Brow Artist Superliner 02 Blonde	COL name VAL L'OrÃ©al Paris Brow Artist Shaper KaÅŸ Kalemi 02 Blonde	1
COL name VAL L'OrÃ©al Paris Infaillible 24H FondÃ¶ten 230 RADIANT HONEY	COL name VAL L'OrÃ©al Paris Infaillible 24H FondÃ¶ten - 230 Radiant Honey	1
COL name VAL L'OrÃ©al Paris Infaillible TÃ¼m YÃ¼ze Uygulanabilir KapatÄ±cÄ± 327 Cashmere	COL name VAL L'oreal paris Infaillible TÃ¼m YÃ¼ze Uygulanabilir KapatÄ±cÄ± 322 Ivory	0
COL name VAL L'OrÃ©al Paris Color Riche Matte Addiction Ruj 640 Erotique - Nude	COL name VAL L'oreal paris Mat Ruj - Color Riche Matte Addiction Lipstick 640 Erotique	1
COL name VAL Loreal Paris L'oreal Paris True Match FondÃ¶ten 1R1C1K Ivory Rose	COL name VAL L'oreal paris True Match FondÃ¶ten 1r1c1k Ivory Rose	0
COL name VAL L'OrÃ©al Paris Color Riche Free The Nudes Ruj - No Prejudice	COL name VAL L'oreal paris Ruj - Color Riche Free The Nudes 12 No Prejudice Clrchfreends	1
COL name VAL L'oreal paris True Match BakÄ±m Yapan FondÃ¶ten 0.5n PorcelaÄ±n	COL name VAL L'OrÃ©al Paris True Match BakÄ±m Yapan FondÃ¶ten 0.5N PorcelaÄ±n	1
COL name VAL L'oreal paris Micellar Makyaj Temizleme Suyu Normalden Ve Karmaya Hassas Ciltler IÃ§in 200 ml	COL name VAL L'Oreal ParisÂ Micellar Makyaj Temizleme Suyu Normalden Ve Karmaya Hassas Ciltler Ä°Ã§in 200 ml	1
COL name VAL L'oreal paris Color Riche Plump & Shine Ruj 101 Nectarine Plump	COL name VAL L'OrÃ©al Paris Color Riche Plump & Shine Ruj 101 Nectarine Plump	1
COL name VAL L'OrÃ©al Paris Infaillible Shaping Stick AllÄ±k 002 Nude Ä°n Rose	COL name VAL L'oreal paris Stick AllÄ±k - Infaillible Shaping Stick AllÄ±k 002 Nude in Rose	1
COL name VAL Loreal Paris Mardinal L'oreal Paris Visible Lift Serum InsÄ±de Mat 100	COL name VAL L'oreal paris Visible Lift Serum InsÄ±de Mat 100	0
COL name VAL L'oreal paris Lash Paradise Intense Black Ekstra Siyah Maskara	COL name VAL Loreal Paris Paradise Intense Black Ekstra Siyah Maskara x 2	0
COL name VAL Loreal Paris L'orÃ©al Paris Mega Volume Collagene 24H Siyah Maskara	COL name VAL Loreal expert L'orÃ©al Paris Mega Volume Collagene 24h Siyah Maskara	0
COL name VAL L'orÃ©al Paris Brilliant Signature Plump In Gloss Ruj 402 I Soar	COL name VAL L'oreal paris L'orÃ©al Paris Brilliant Signature Plump In Gloss Ruj 404 I Insert	0
COL name VAL L'oreal paris Color Riche Satin Ruj 110	COL name VAL Loreal Paris Loreal Color Riche Lipstick 110	1
COL name VAL L'oreal paris Ruj - Color Riche Free The Nudes 11 No Dependency	COL name VAL Loreal Paris L'orÃ©al Paris Color Riche Free The Nudes Ruj - No Dependency	1
COL name VAL L'OrÃ©al Paris Infaillible 24H FondÃ¶ten 300 Amber	COL name VAL L'oreal paris L'OrÃ©al Paris Infaillible 24H FondÃ¶ten 300 Amber	1
COL name VAL Loreal Paris L'oreal Paris Unbelieva Brow Uzun SÃ¼re KalÄ±cÄ± Åžeffaf KaÅŸ MaskarasÄ±	COL name VAL L'oreal paris Unbelieva Brow Uzun SÃ¼re KalÄ±cÄ± Åžeffaf KaÅŸ MaskarasÄ±	1
COL name VAL L'OrÃ©al Paris Unlimited Siyah Maskara	COL name VAL L'Oreal Paris Unlimited Siyah Maskara	1
COL name VAL L'Oreal Paris False Lash Wings Mascara Ä°ntenza 7 ML Siyah	COL name VAL L'oreal paris Siyah Maskara - False Lash Butterfly Effect Intenza	1
COL name VAL L'oreal paris KaÅŸ Kalemi - Brow Artist High Contour 102 Cool Blonde	COL name VAL L'OrÃ©al Paris Brow Artist High Contour 102 Cool Blond - SarÄ±ÅŸÄ±n	1
COL name VAL L'oreal paris AllÄ±k - True Match Le Blush No: 160 Peach	COL name VAL L'OrÃ©al Paris True Match AllÄ±k 160 PEACH	1
COL name VAL L'OrÃ©al Paris Rouge Signature Likit Mat Ruj - 103 I Enjoy	COL name VAL L'oreal paris Likit Mat Ruj - Rouge Signature 103 Enjoy	1
COL name VAL L'OrÃ©al Paris Infaillible 24H FondÃ¶ten 145 BEIGE ROSE	COL name VAL Loreal expert Loreal Paris Infaillible 24h FondÃ¶ten 145 Beige Rose	0
COL name VAL L'oreal paris True Match Foundation 1.5n Linen FondÃ¶ten -3600522840114	COL name VAL L'OrÃ©al Paris True Match BakÄ±m Yapan FondÃ¶ten 1.5 LÄ±nen	1
COL name VAL L'OrÃ©al Paris Xmas Color Riche Lipstick Lipstick Burning Red	COL name VAL L'oreal paris Ruj - Xmas Color Riche Lipstick Lipstick Burning Red	1
COL name VAL L'oreal paris Brow Artist Plump&set Renkli KaÅŸ Sabitleyici Maskara - 108	COL name VAL L'Oreal Paris Brow Artist Plump & Set Dolgun GÃ¶rÃ¼nÃ¼m Veren KaÅŸ Sa	1
COL name VAL L'oreal paris L'orÃ©al Paris True Match BakÄ±m Yapan FondÃ¶ten 7.5d Golden Chestnut	COL name VAL L'OrÃ©al Paris True Match BakÄ±m Yapan FondÃ¶ten 7.5D Golden Chestnut	1
COL name VAL L'oreal paris Infaillible 24h Fresh Wear Pudra FondÃ¶ten 220 Sand	COL name VAL L'OrÃ©al Paris Infaillible 24H Fresh Wear Pudra FondÃ¶ten 180 Rose Sand	0
COL name VAL Loreal Paris Loreal Micellar Makyaj Temizleyici Air Volume Maskara Seti	COL name VAL L'oreal paris Loreal Micellar Makyaj Temizleyici Air Volume Maskara Seti	0
COL name VAL L'oreal paris Telescopic Carbon Extra Black Maskara - Siyah	COL name VAL L'OrÃ©al Paris Telescopic Carbon Black Maskara - Siyah	1
COL name VAL L'Oreal Paris Les Chocolats Ultra Matte Likit Ruj 856 %70 Yum	COL name VAL L'oreal paris Les Chocolats Ultra Matte Liquid Lipstick 856 Yum	1
COL name VAL L'oreal paris True Match BakÄ±m Yapan FondÃ¶ten 1D GOLDEN IVORY	COL name VAL L'oreal Paris True Match BakÄ±m Yapan FondÃ¶ten 1n Ivory FondÃ¶ten	0
COL name VAL Loreal Paris Infallible Longwear Lip Liner 701 Stay Ultraviolet	COL name VAL Loreal botanicals Loreal Paris Infallible Longwear Lip Liner 701 Stay Ultraviolet	0
COL name VAL L'OrÃ©al Paris Superliner Tattoo Signature Liner Ekstra Siyah	COL name VAL L'oreal paris Ekstra Siyah Likit Eyeliner - Superliner Tattoo Signature Liner	1
COL name VAL L'oreal Paris Bambi Eye Extra Black Ceylan GÃ¶z Etkili Maskara Ekstra Siyah	COL name VAL L'oreal paris Bambi Eye Ceylan GÃ¶z Etkili Siyah Maskara 30175792	0
COL name VAL L'Oreal Paris Color Riche Matte Addiction Ruj 655 Copper Clutch	COL name VAL L'OrÃ©al Paris Color Riche Matte Addiction Ruj 655 Copper Clutch - Kahverengi	1
COL name VAL L'OrÃ©al Paris Color Riche Free The Nudes Ruj - No Prejudice	COL name VAL L'oreal paris Ruj - Color Riche Free The Nudes 12 No Prejudice	1
COL name VAL L'oreal paris Likit Mat Ruj - Les Chocolats Ultra Matte Liquid Lipstick 852 Box Of Chocolates	COL name VAL L'OrÃ©al Paris Les Chocolats Likit Mat Ruj 852 Box Of Chocolates	1
COL name VAL L'OrÃ©al Paris Merry Metals Superliner 03 Gold	COL name VAL L'oreal paris Eyeliner - Merry Metals Superliner 03 Gold	1
COL name VAL L'OrÃ©al Paris Infaillible 24H Ruj 117 PERPETUAL BROWN- Kahverengi	COL name VAL L'oreal paris 24 Saat KalÄ±cÄ± Ruj - Infaillible Rouge 117 Perpetual Brown	1
COL name VAL L'orÃ©al Paris Color Riche Plump & Shine Ruj 101 Nectarine Plump	COL name VAL L'oreal paris Glow Paradise Ruj Balm-in-lipstick 244 Apricot Desire-kayÄ±sÄ±  3600523687114-244	1
COL name VAL L'oreal paris L'orÃ©al Paris True Match BakÄ±m Yapan FondÃ¶ten 5n Sand	COL name VAL L'oreal Paris True Match BakÄ±m Yapan FondÃ¶ten 5n Sand FondÃ¶ten	0
COL name VAL L'OrÃ©al Paris Telescopic Carbon Black Maskara - Siyah	COL name VAL L'oreal paris Telescopic Carbon Extra Black Maskara - Siyah	1
COL name VAL Loreal Paris Loreal Color Riche Lipstick 125	COL name VAL L'oreal paris KadÄ±n No Color Ruj	1
COL name VAL Loreal Paris AydÄ±nlatÄ±cÄ± Palet En Glow Warm Glow Air Volume Maskara Seti	COL name VAL L'oreal paris AydÄ±nlatÄ±cÄ± Palet En Glow Warm Glow Air Volume Maskara Seti	0
COL name VAL L'OrÃ©al Paris Color Riche Shine Naked Tans Ruj 656 Beige In The City - Nude	COL name VAL L'oreal paris Color Riche Shine Naked Tans Ruj 658 Topless - Nude	1
COL name VAL Loreal Paris L'oreal Paris False Lash Telescopic Fiber Maskara - Siyah Maskara	COL name VAL L'oreal paris Paris False Lash Telescopic Fiber Maskara	0
COL name VAL L'OrÃ©al Paris Rouge Signature Parisian Sunset Likit Mat Ruj - 128 I Decide	COL name VAL L'oreal paris Rouge Signature Parisian Sunset Likit Mat Ruj 128Decide	1
COL name VAL L'oreal paris L'orÃ©al Paris True Match BakÄ±m Yapan FondÃ¶ten 5d Golden Sand	COL name VAL L'OrÃ©al Paris True Match BakÄ±m Yapan FondÃ¶ten 2D Golden Almond	0
COL name VAL L'oreal paris L'OrÃ©al Paris Bambi Eye Ceylan GÃ¶z Etkili Maskara - Siyah	COL name VAL L'oreal Paris Bambi Eye Extra Black Ceylan GÃ¶z Etkili Maskara Ekstra Siyah	0
COL name VAL Loreal Paris ÃœÃ§ Etkili Makyaj Temizleme Suyu Kuru - Hassas Ciltler 200 ml	COL name VAL L'oreal paris Kuru ve Hassas Ciltler iÃ§in ÃœÃ§ Etkili Makyaj Temizleme Suyu 200 ml	0
COL name VAL L'OrÃ©al Paris True Match BakÄ±m Yapan FondÃ¶ten 1.5 LÄ±nen	COL name VAL L'oreal paris True Match BakÄ±m Yapan FondÃ¶ten 1.5 LINEN	1
COL name VAL L'oreal paris Pembe Color Riche Saten BitiÅŸli Violet Saturne Ruj 214	COL name VAL L'orÃ©al Paris Color Riche Saten BitiÅŸli Ruj 214 Violet Saturne - Pembe 1 Paket (1 X 9.1 G)	0
COL name VAL L'OrÃ©al Paris Color Riche Plump & Shine Ruj 107 Coconut Plump	COL name VAL L'oreal paris Color Riche Plump & Shine Ruj	1
COL name VAL L'OrÃ©al Paris Infaillible TÃ¼m YÃ¼ze Uygulanabilir KapatÄ±cÄ± 323 Fawn	COL name VAL L'oreal paris Infaillible TÃ¼m YÃ¼ze Uygulanabilir KapatÄ±cÄ± 322 Ivory	0
COL name VAL L'oreal paris Color Riche Exclusive Reds Freida's Red Ruj	COL name VAL L'OrÃ©al Paris Color Riche Ruj Exclusive Reds FREIDA'S PURE RED	0
COL name VAL L'OrÃ©al Paris Infaillible 24H Matte Cover YÃ¼ksek KapatÄ±cÄ± FondÃ¶ten - 25 Rose Ivory	COL name VAL L'oreal paris Infaillible 24H Matte Cover YÃ¼ksek KapatÄ±cÄ± FondÃ¶ten 25 Rose Ivory	1
COL name VAL L'oreal paris Color Queen Tekli GÃ¶z FarÄ± 09 High Potential	COL name VAL L'OrÃ©al Paris Color Queen Tekli GÃ¶z FarÄ± 09 High Potential	1
COL name VAL L'oreal paris True Match BakÄ±m Yapan FondÃ¶ten 2R ROSE VANILLA	COL name VAL Loreal Paris L'oreal Paris True Match BakÄ±m Yapan FondÃ¶ten 2r Rose Vanilla	0
COL name VAL L'oreal paris Visible Lift Serum InsÄ±de Mat 100	COL name VAL Loreal Paris Mardinal L'oreal Paris Visible Lift Serum InsÄ±de Mat 100	0
COL name VAL L'OrÃ©al Paris Rouge Signature Parisian Sunset Likit Mat Ruj - 127 I Revolutionize	COL name VAL L'oreal paris Rouge Signature Parisian Sunset Likit Mat Ruj 127revolutionize	0
COL name VAL L'oreal paris Mat Ruj - Color Riche Matte Addiction Lipstick 640 Erotique	COL name VAL L'OrÃ©al Paris Color Riche Matte Addiction Ruj 640 Erotique - Nude	1
COL name VAL Loreal Paris Bambi Eye Ceylan GÃ¶z Etkili Maskara - Siyah X2	COL name VAL L'oreal paris L'OrÃ©al Paris Bambi Eye Ceylan GÃ¶z Etkili Maskara - Siyah	0
COL name VAL L'oreal paris Ruj - Color Riche Shine Addiction Lipstick 111 Instaheaven	COL name VAL L'OrÃ©al Paris Color Riche Shine Ruj 111 Instaheaven - Pembe	1
COL name VAL L'OrÃ©al Paris Infaillible 24H Ultra Matte Prestige Pudra-225 Beige	COL name VAL L'oreal paris Mat Pudra - Infaillible 24H Ultra Matte Prestige Pudra 225 Beige	1
COL name VAL L'oreal paris L'orÃ©al Paris Bambi Eye Oversized Ceylan GÃ¶z Etkili Maskara - Siyah	COL name VAL Loreal Paris L'orÃ©al Paris Bambi Eye Ceylan GÃ¶z Etkili Maskara, Siyah, 8.9 ml	0
COL name VAL L'OrÃ©al Paris Infaillible Metallic Lip Paint 306 Lolita	COL name VAL L'OREAL PARÄ°S RUJ - LÄ°P PAÄ°NT METALLÄ°C 306 LOLÄ°TA	1
COL name VAL L'oreal paris 24H Fresh Wear FondÃ¶ten 125 Natural Rose & KapatÄ±cÄ± 327 Cashmere + Makyaj Organizer 36005236145161	COL name VAL Loreal Paris 24H Fresh Wear FondÃ¶ten 125 Natural Rose & KapatÄ±cÄ± 327 Cashmere + Makyaj Organizer	0
COL name VAL L'oreal paris Brilliant Signature Plump In Gloss Ruj Seti - 412 I Heighten & 402 I Soar & Ã‡anta	COL name VAL L'orÃ©al Paris Brilliant Signature Plump In Gloss Ruj 412 I Heighten	0
COL name VAL L'OrÃ©al Paris Extraordinaire 101 Rose Melody	COL name VAL L'oreal paris Likit Ruj - Color Riche L'Extraordinaire Lipstick 101 Rose Melody	1
COL name VAL L'Oreal Paris Rouge Signature Matte Likit Ruj 113 Dont	COL name VAL L'oreal paris Rouge Signature Likit Mat Ruj - 113 I Don't	1
COL name VAL L'OrÃ©al Paris Color Queen Tekli GÃ¶z FarÄ± 02 Force	COL name VAL L'oreal paris Color Queen Tekli GÃ¶z FarÄ± 02 Force	1
COL name VAL L'oreal paris Likit Metalik Ruj - Rouge Signature Metallic 202 I Electrify	COL name VAL L'OrÃ©al Paris Rouge Signature Metallic Likit Ruj - 202 I Electrify	1
COL name VAL L'oreal paris L'orÃ©al Paris True Match Nude FondÃ¶ten Serum 2-3 Light	COL name VAL L'OrÃ©al Paris True Match Nude FondÃ¶ten Serum 2-3 Light	1
COL name VAL L'OrÃ©al Paris Superliner Smokissime Eyeliner BLACK	COL name VAL Loreal Paris Superliner Smokissime Eyeliner	1
COL name VAL Loreal Paris L'oreal Paris True Match BakÄ±m Yapan FondÃ¶ten 4n Beige	COL name VAL L'oreal paris True Match BakÄ±m Yapan FondÃ¶ten 1.5 LINEN	0
COL name VAL L'oreal paris Loreal True Match Foundation 1rc Rose Ivory FondÃ¶ten SÃ¼ngeri Seti	COL name VAL Loreal True Match Foundation 1n Ivory FondÃ¶ten SÃ¼ngeri Seti	0
COL name VAL L'OrÃ©al Paris Infaillible Magic Loose Powder - Transparan Toz Pudra	COL name VAL L'oreal paris Infaillible Magic Loose Powder - Transparan Toz Pudra	1
COL name VAL L'oreal paris Bambi Eye Ceylan GÃ¶z Etkili Suya DayanÄ±klÄ± Maskara - Siyah 30178625	COL name VAL L'oreal Paris Bambi Eye Waterproof Suya DayanÄ±klÄ± Ceylan GÃ¶z Etkili Maskara	1
COL name VAL L'oreal paris Siyah Bambi Eye Oversized Ceylan GÃ¶z Etkili Maskara	COL name VAL Loreal Paris L'orÃ©al Paris Bambi Eye Ceylan GÃ¶z Etkili Maskara, Siyah, 8.9 ml	0
COL name VAL L'Oreal Paris Rouge Signature Matte Likit Ruj 113 Dont	COL name VAL L'OrÃ©al Paris Rouge Signature Likit Mat Ruj - 113 I don't	1
COL name VAL L'OrÃ©al Paris Infaillible Matte Max Ruj 008 I GOTTA FEELING	COL name VAL L'oreal paris Mat Ruj - Infallible Matte Rouge 008 I Gotta Feeling	1
COL name VAL L'oreal paris L'OrÃ©al Paris True Match BakÄ±m Yapan FondÃ¶ten 1.5 Linen	COL name VAL L'OrÃ©al Paris True Match BakÄ±m Yapan FondÃ¶ten 5N SAND	0
COL name VAL L'OrÃ©al Paris Infaillible Shaping Stick FondÃ¶ten 190 Beige Dore	COL name VAL L'oreal paris Stick FondÃ¶ten Infaillible Shaping Stick FondÃ¶ten 190 Beige Dore	0
COL name VAL L'oreal paris Rouge Signature Parisian Sunset Likit Mat Ruj 127revolutionize	COL name VAL L'OrÃ©al Paris Rouge Signature Parisian Sunset Likit Mat Ruj - 127 I Revolutionize	0
COL name VAL L'orÃ©al Paris Micellar Kusursuz Makyaj Temizleme Suyu Hassas 400ML	COL name VAL L'oreal paris L'orÃ©al Paris Kusursuz Makyaj Temizleme Suyu Hassas 400 ml	0
COL name VAL L'OrÃ©al Paris Color Riche Ruj Exclusive Reds JLO'S PURE RED	COL name VAL L'oreal paris Ruj - Color Riche Exclusive Reds - JLO's Red	1
COL name VAL Loreal Paris Loreal True Match Nude Serum FondÃ¶ten Light FondÃ¶ten FÄ±rÃ§asÄ±	COL name VAL L'oreal paris L'orÃ©al Paris True Match Nude FondÃ¶ten Serum 2-3 Light	0
COL name VAL L'OrÃ©al Paris True Match Prestige Pudra- 2N Vanilla	COL name VAL L'oreal paris Pudra - True Match Prestige Powder 2N Vanilla	1
COL name VAL L'oreal paris Lash Paradise Intense Black Ekstra Siyah Maskara	COL name VAL L'oreal Paris Lash Paradise Intense Black Ekstra Siyah Maskara	1
COL name VAL L'oreal paris KapatÄ±cÄ± - True Match Concealer 02 Vanilla	COL name VAL L'OrÃ©al Paris True Match KapatÄ±cÄ± 02 VANILLA	1
COL name VAL L'Oreal Paris Les Chocolats Ultra Matte Likit Mat Ruj 844 Sweet Tooth	COL name VAL L'oreal paris Likit Mat Ruj - Les Chocolats Ultra Matte Liquid Lipstick 844 Sweet Tooth	1
COL name VAL L'oreal paris Stick FondÃ¶ten - Infaillible Shaping Stick FondÃ¶ten 140 Natural Rose	COL name VAL L'OrÃ©al Paris Infaillible Shaping Stick FondÃ¶ten 140 Natural Rose	1
COL name VAL L'OrÃ©al Paris Color Riche Shine Addiction Ruj 906 Girlsnight	COL name VAL L'oreal paris - Ruj - Color Riche Shine Addiction Lipstick 906 Girls Night	1
COL name VAL Loreal True Match Foundation 1n Ivory FondÃ¶ten SÃ¼ngeri Seti	COL name VAL L'oreal paris Loreal True Match Foundation 1rc Rose Ivory FondÃ¶ten SÃ¼ngeri Seti	0
COL name VAL Loreal Paris L'oreal Paris True Match FondÃ¶ten 1R1C1K Ivory Rose	COL name VAL L'oreal paris True Match FondÃ¶ten 1R1c1k Ivoire R	0
COL name VAL L'OrÃ©al Paris Les Macarons Likit Mat Ruj 834 Infinite Spice	COL name VAL L'oreal paris Likit Mat Ruj - Les Macarons Ultra Matte Liquid Lipstick 834 Infinite Spice	1
COL name VAL Loreal Paris Loreal True Match Nude Serum FondÃ¶ten Light Medium FondÃ¶ten FÄ±rÃ§asÄ±	COL name VAL L'oreal paris L'orÃ©al Paris True Match Nude FondÃ¶ten Serum 3-4 Light Medium	0
COL name VAL L'OrÃ©al Paris Mega Gloss Lip Gloss 407 SMOKE ME UP	COL name VAL L'oreal paris Ruj - Infallible Mega Gloss 407 Smoke Me Up	1
COL name VAL L'oreal paris Dudak Kalemi - Infaillible Lip Pencil 207 Wuthering Purple	COL name VAL L'OrÃ©al Paris Infaillible Dudak Kalemi 207 Wuthering Purple- MÃ¼rdÃ¼m	1
COL name VAL L'oreal paris L'orÃ©al Paris Glow Paradise Balm-in-lipstick - IÅŸÄ±ltÄ± Veren Ruj 642 Beige Eden	COL name VAL L'OrÃ©al Paris Color Riche Shine Ruj 642 MLBB - Nude	1
COL name VAL L'OrÃ©al Paris True Match BakÄ±m Yapan FondÃ¶ten 3D GOLDEN BEIGE	COL name VAL L'oreal paris L'orÃ©al Paris True Match BakÄ±m Yapan FondÃ¶ten 5d Golden Sand	0
COL name VAL L'oreal paris Infaillible 24h Matte Cover YÃ¼ksek KapatÄ±cÄ± FondÃ¶ten 110 Rose Vanilla	COL name VAL L'OrÃ©al Paris Infaillible 24H Matte Cover YÃ¼ksek KapatÄ±cÄ± FondÃ¶ten - 110 Rose Vanilla	1
COL name VAL L'OrÃ©al Paris Color Riche Les Nus Ruj 179 Nu Decadent	COL name VAL L'Oreal Paris Color Riche Les Nus Ruj 179 Decadent	1
COL name VAL L'oreal paris Likit Metalik Ruj - Rouge Signature Metallic 205 I Fascinate	COL name VAL L'OrÃ©al Paris Rouge Signature Metallic Likit Ruj - 205 I Fascinate	1
COL name VAL L'OrÃ©al Paris True Match BakÄ±m Yapan FondÃ¶ten 3R ROSE BEIGE	COL name VAL L'oreal paris True Match BakÄ±m Yapan FondÃ¶ten 3R ROSE BEIGE	0
COL name VAL L'OrÃ©al Paris True Match BakÄ±m Yapan FondÃ¶ten 6N HONEY	COL name VAL L'oreal paris True Match Foundation 6n Honey 30 ml FondÃ¶ten -	1
COL name VAL L'oreal paris L'OrÃ©al Paris Infaillible TÃ¼m YÃ¼ze Uygulanabilir KapatÄ±cÄ± 338 Honey	COL name VAL L'OrÃ©al Paris Infaillible TÃ¼m YÃ¼ze Uygulanabilir KapatÄ±cÄ± 334 Walnut	0
COL name VAL L'oreal paris Bambi Eye Ceylan GÃ¶z Etkili Siyah Maskara	COL name VAL Loreal Paris L'orÃ©al Paris Bambi Eye Ceylan GÃ¶z Etkili Maskara, Siyah, 8.9 ml	0
COL name VAL L'OrÃ©al Paris Color Riche Matte Addiction Ruj 471 Voodoo - Mor	COL name VAL L'oreal paris Riche Matte Addiction Ruj 471 Voodoo	1
COL name VAL L'OrÃ©al Paris Infaillible Sexy Balm Ruj 103 AS IF!	COL name VAL L'oreal paris Ruj - Infallible Sexy Balm 103 As If	1
COL name VAL Loreal Paris True Match Nude Serum FondÃ¶ten 0.5-2 Very Light	COL name VAL L'oreal paris L'orÃ©al Paris True Match Nude FondÃ¶ten Serum 2-3 Light	0
COL name VAL Loreal Paris Rimel Volume MÄ±llÄ±on Lashes Cannes Ã–zel TasarÄ±m Siyah	COL name VAL L'oreal paris Volume Million Lashes Maskara Cannes Koleksiyonu Ã–zel TasarÄ±m	1
COL name VAL L'OrÃ©al Paris Bambi Eye Ceylan GÃ¶z Etkili Maskara - Siyah	COL name VAL L'oreal paris L'orÃ©al Paris Bambi Eye Oversized Ceylan GÃ¶z Etkili Maskara - Siyah	0
COL name VAL L'orÃ©al Paris True Match BakÄ±m Yapan FondÃ¶ten 1r Rose Ivory, 30 ml	COL name VAL L'oreal paris True Match BakÄ±m Yapan FondÃ¶ten 1N IVORY	0
COL name VAL Loreal expert Loreal Paris Infaillible 24h FondÃ¶ten 145 Beige Rose	COL name VAL L'OrÃ©al Paris Infaillible 24H FondÃ¶ten 145 BEIGE ROSE	0
COL name VAL L'OrÃ©al Paris True Match BakÄ±m Yapan FondÃ¶ten - 5D Golden Sand	COL name VAL L'oreal paris Loreal True Match Foundation 5d Golden Sand FondÃ¶ten SÃ¼ngeri Seti	1
COL name VAL L'OrÃ©al Paris Rouge Signature Parisian Sunset Likit Mat Ruj - 132 I Radiate	COL name VAL L'oreal paris Rouge Signature Parisian Sunset Likit Mat Ruj 132Radiate	1
COL name VAL L'oreal paris Super Liner Black Lacquer Waterproof Eyeliner 6 Ml	COL name VAL L'OrÃ©al Paris Superliner Black Lacquer Waterproof Eyeliner - Siyah	1
COL name VAL L'oreal paris Ruj - Color Riche Free The Nudes 08 No Lies	COL name VAL L'OrÃ©al Paris Color Riche Free The Nudes Ruj - No Lies	1
COL name VAL Loreal Paris Ruj Color Riche Collection Privee Doutzen's Nude	COL name VAL L'oreal paris Ruj - Color Riche Privee Nudes - Doutzen's Nude	1
COL name VAL L'oreal paris KarÄ±ÅŸtÄ±rma FÄ±rÃ§asÄ±	COL name VAL L'OrÃ©al Paris Makyaj FÄ±rÃ§asÄ±-Blending Brush (KarÄ±ÅŸtÄ±rma FÄ±rÃ§asÄ±)	1
COL name VAL L'OrÃ©al Paris True Match Prestige Pudra- 3D Golden Beige	COL name VAL L'oreal paris Pudra - True Match Prestige Powder 3d Golden Beige	1
COL name VAL L'oreal paris True Match BakÄ±m Yapan FondÃ¶ten 9N TRUFFE	COL name VAL L'OrÃ©al Paris True Match BakÄ±m Yapan FondÃ¶ten 9N Truffe	1
COL name VAL L'oreal paris La Vie En Glow Highlighting Powder Pallette Cool Glow AydÄ±nlatÄ±cÄ± Paleti	COL name VAL L'OrÃ©al Paris La Vie En Glow AydÄ±nlatÄ±cÄ± Paleti Cool Glow - SoÄŸuk Tonlar	1
COL name VAL Loreal Paris L'orÃ©al Paris True Match BakÄ±m Yapan FondÃ¶ten 1r Rose Ivory, 30 ml	COL name VAL L'oreal paris True Match BakÄ±m Yapan FondÃ¶ten 1R ROSE IVORY	0
COL name VAL L'oreal paris True Match BakÄ±m Yapan FondÃ¶ten 4n BeÄ±ge	COL name VAL L'OrÃ©al Paris True Match BakÄ±m Yapan FondÃ¶ten 4.5N True BeÄ±ge	0
COL name VAL L'oreal paris Uzun SÃ¼re KalÄ±cÄ± FondÃ¶ten - Infaillible 24h Fresh Wear 130 True Beige 30 ml	COL name VAL L'OrÃ©al Paris Infaillible 24H FondÃ¶ten 130 TRUE BEIGE	1
COL name VAL Loreal Paris Paradise Extatic Siyah Maskara	COL name VAL L'oreal paris Paradise Extatic Siyah Maskara	1
COL name VAL L'oreal paris L'orÃ©al Paris True Match Nude FondÃ¶ten Serum 3-4 Light Medium	COL name VAL Loreal Paris Loreal True Match Nude Serum FondÃ¶ten Light Medium 360 FondÃ¶ten FÄ±rÃ§asÄ±	0
COL name VAL Loreal Paris Super Liner Gelmatic 03 Taupe Grey - Gri GÃ¶z Kalemi	COL name VAL L'oreal paris Mat Gri Superliner - Superliner Mat Matic 03 Taupe Grey	1
COL name VAL L'oreal paris Ruj - Color Riche Free The Nudes 02 No Cliche	COL name VAL L'OrÃ©al Paris Color Riche Free The Nudes Ruj - No Lies	0
COL name VAL L'oreal paris Ruj - Color Riche Matte Addiction Lipstick 463 Plum Tuxedo	COL name VAL L'OrÃ©al Paris Color Riche Matte Addiction Ruj 463 Plum Tuxedo	1
COL name VAL L'OrÃ©al Paris Color Queen Tekli GÃ¶z FarÄ± 33 Extra	COL name VAL L'oreal paris Tekli GÃ¶z FarÄ± - Color Queen Mono Eyeshadow 33 Extra 30173316	1
COL name VAL L'oreal paris Likit Mat Ruj - Rouge Signature 105 Rule	COL name VAL L'Oreal Paris Rouge Signature Matte Likit Ruj 105 Rule	1
COL name VAL L'oreal paris GÃ¶z FarÄ± - Infallible Paint Nude Eyeshadow Peach Me Babe	COL name VAL L'OrÃ©al Paris Infallible Eye Paint No 305 - Peach Me Babe	1
COL name VAL L'oreal paris Mat Ruj Paleti - Color Riche La Palette Lip Matte 01 Bold	COL name VAL L'OrÃ©al Paris Color Riche La Palette Mat Ruj Paleti La Palette Bold	1
COL name VAL L'OrÃ©al Paris Infaillible Shaping Stick AydÄ±nlatÄ±cÄ± 501 Oh my Jewels	COL name VAL L'oreal paris Stick AydÄ±nlatÄ±cÄ± - Infaillible Shaping Stick 501 Oh My Jewels	1
COL name VAL L'OrÃ©al Paris Infaillible 24H Matte Cover YÃ¼ksek KapatÄ±cÄ± FondÃ¶ten - 145 Rose Beige	COL name VAL L'oreal paris Infaillible 24h Matte Cover YÃ¼ksek KapatÄ±cÄ± FondÃ¶ten 155 Natural Rose	0
COL name VAL L'oreal paris L'OrÃ©al Paris True Match BakÄ±m Yapan FondÃ¶ten 1.5 Linen	COL name VAL L'OrÃ©al Paris True Match BakÄ±m Yapan FondÃ¶ten 1.5 LÄ±nen	0
COL name VAL L'oreal paris Mega Volume Collagene 24H Siyah Maskara	COL name VAL Loreal Paris L'orÃ©al Paris Mega Volume Collagene 24H Siyah Maskara	0
COL name VAL Loreal Paris Volume Million Lashes Carbon Black Maskara - Siyah	COL name VAL L'oreal paris Siyah Maskara - Volume Million Lashes Feline Mascara Black	0
COL name VAL L'oreal paris True Match BakÄ±m Yapan FondÃ¶ten 1n Ivory	COL name VAL L'OrÃ©al Paris True Match BakÄ±m Yapan FondÃ¶ten 1D Golden Ivory	0
COL name VAL L'OrÃ©al Paris True Match BakÄ±m Yapan FondÃ¶ten 5N SAND	COL name VAL L'oreal paris L'orÃ©al Paris True Match BakÄ±m Yapan FondÃ¶ten 4n BeÄ±ge	0
COL name VAL L'oreal paris Siyah Eyeliner - Smokissime Superliner 100 Black	COL name VAL L'OrÃ©al Paris Superliner Smokissime Eyeliner BLACK	0
COL name VAL Loreal Paris Infallible Longwear Lip Liner 105 Red Fiction	COL name VAL Loreal botanicals Loreal Paris Infallible Longwear Lip Liner 105 Red Fiction	0
COL name VAL L'OrÃ©al Paris La Petite Far Paleti - Stylist	COL name VAL Loreal botanicals GÃ¶z FarÄ± Paleti - La Petite Palette Stylist	1
COL name VAL L'OrÃ©al Paris Mascara Telescopic Black	COL name VAL L'oreal paris Loreal Paris L'orÃ©al Paris Mascara Telescopic Black.	0
COL name VAL L'OrÃ©al Paris True Match BakÄ±m Yapan FondÃ¶ten 5D GOLDEN SAND	COL name VAL L'OrÃ©al Paris True Match BakÄ±m Yapan FondÃ¶ten 5D Golden Sand	1
COL name VAL L'OrÃ©al Paris Infaillible 24H Matte Cover YÃ¼ksek KapatÄ±cÄ± FondÃ¶ten - 110 Rose Vanilla	COL name VAL L'oreal paris Infaillible 24h Matte Cover YÃ¼ksek KapatÄ±cÄ± FondÃ¶ten 155 Natural Rose	0
COL name VAL L'Oreal Paris Emotions Of Nu AllÄ±k & Far Paleti	COL name VAL L'oreal paris Emotions of Nu AllÄ±k & Far Paleti	1
COL name VAL L'OrÃ©al Paris Color Riche Free The Nudes Ruj - No Lies	COL name VAL L'oreal paris Ruj - Color Riche Free The Nudes 02 No Cliche	0
COL name VAL L'oreal paris L'orÃ©al Paris Color Riche Plump & Shine Ruj	COL name VAL L'orÃ©al Paris Color Riche Plump & Shine Ruj 101 Nectarine Plump	0
COL name VAL L'OrÃ©al Paris Brow Artist High Contour 105 Brunette - Kumral	COL name VAL L'oreal paris KaÅŸ Kalemi - Brow Artist High Contour 108 Warm Brown	1
COL name VAL Loreal Paris L'oreal Paris Infaillible 24H Matte Cover YÃ¼ksek KapatÄ±cÄ± FondÃ¶ten No: 300 Amber	COL name VAL L'oreal paris Infaillible 24H Matte Cover YÃ¼ksek KapatÄ±cÄ± FondÃ¶ten 300 Amber	0
COL name VAL L'OrÃ©al Paris Infaillible Shaping Stick AllÄ±k 001 Sexy Flush	COL name VAL L'oreal paris Stick AllÄ±k - Infaillible Shaping Stick AllÄ±k 001 Sexy Flush	1
COL name VAL Loreal Paris L'oreal Paris Telescopic Carbon Black Maskara - Siyah & Infaillible 24H Fresh Wear Pudra FondÃ¶ten 120 Vanilla	COL name VAL L'oreal paris Telescopic Gold Siyah Maskara & Infaillible 24h Fresh Wear Pudra FondÃ¶ten 120 Vanilla	0
COL name VAL Loreal Paris L'oreal Paris Bambi Eye Ceylan GÃ¶z Etkili Maskara Eks. Siyah Maskara	COL name VAL L'oreal paris Bambi Eye Extra Black Ceylan GÃ¶z Etkili Maskara Ekstra Siyah	0
COL name VAL L'oreal paris Ruj - Lip Paint Metallic 306 Lolita	COL name VAL L'Oreal Paris Ruj Lip Paint Metallic 306 Lolita	1
COL name VAL L'oreal paris C'Ã©st Magic BB Krem 05 Medium Dark	COL name VAL L'OrÃ©al Paris C'Ã‰st Magic Bb Krem 05 Medium Dark	1
COL name VAL L'oreal paris Tekli GÃ¶z FarÄ± - Color Queen Mono Eyeshadow 29 Ruthless 30173279	COL name VAL L'Oreal Paris Color Queen Tekli GÃ¶z FarÄ± 29 Ruthless	1
COL name VAL L'OrÃ©al Paris Mega Gloss Lip Gloss 404 RASPOUTINE ME	COL name VAL L'oreal paris Ruj - Infallible Mega Gloss 404 Raspoutine Me	1
COL name VAL L'oreal Paris Color Riche Free The Nudes Ruj - No Pressure	COL name VAL L'oreal paris Ruj - Color Riche Free The Nudes 05 No Diktat	0
COL name VAL L'oreal paris KaÅŸ Kalemi - Brow Artist High Contour 108 Warm Brown	COL name VAL L'OrÃ©al Paris Brow Artist High Contour 105 Brunette - Kumral	1
COL name VAL Loreal Paris L'oreal Paris True Match BakÄ±m Yapan FondÃ¶ten 4n Beige	COL name VAL L'oreal paris True Match BakÄ±m Yapan FondÃ¶ten 1N IVORY	0
COL name VAL L'orÃ©al Paris Brilliant Signature Plump In Gloss Ruj 412 I Heighten	COL name VAL L'oreal paris Brilliant Signature Plump In Gloss Ruj Seti - 412 I Heighten & 402 I Soar & Ã‡anta	0
COL name VAL L'orÃ©al Paris Cherie On The Cake AllÄ±k ve BronzlaÅŸtÄ±rÄ±cÄ± Pudra - 02 Dark Chocolate	COL name VAL L'oreal paris Blush Cherie On The Cake & Bronzer 02 Dark Chocolate AllÄ±k & BronzlaÅŸtÄ±rÄ±cÄ± Pudra -	1
COL name VAL Loreal ParÄ±s C'est Magic Bb Krem 05 Medium Dark	COL name VAL Loreal Paris C'Ã©st Magic Bb Krem 05 Medium Dark	1
COL name VAL L'OrÃ©al Paris True Match BakÄ±m Yapan FondÃ¶ten 5R ROSE SAND	COL name VAL L'oreal paris FondÃ¶ten - True Match Foundation 5r Rose Sand 30 Ml	1
COL name VAL L'OrÃ©al Paris Infaillible Shaping Stick AydÄ±nlatÄ±cÄ± 501 Oh my Jewels	COL name VAL L'oreal paris Infaillible Shaping Stick 501 Oh My Jewels Stick AydÄ±nlatÄ±cÄ± - 	1
COL name VAL Loreal Paris L'oreal Paris Micellar Makyaj Temizleme Suyu Normalden Kuruya Hassas Ciltler IÃ§in 200 ml	COL name VAL L'oreal paris Micellar Makyaj Temizleme Suyu Normalden Ve Karmaya Hassas Ciltler IÃ§in	0
COL name VAL L'oreal paris Lash Paradise Intense Black Ekstra Siyah Maskara	COL name VAL Loreal Paris L'orÃ©al Paris Lash Paradise Intense Black Ekstra Siyah Maskara 2'li Set 1 Paket (1 x 2 Adet	0
COL name VAL L'oreal paris Koyu Kahverengi KaÅŸ Kalemi - Brow Artist Shaper 04 Dark Brunette	COL name VAL L'OrÃ©al Paris Brow Artist Shaper KaÅŸ Kalemi 04 Dark Brunette	1
COL name VAL L'OrÃ©al Paris Color Queen Tekli GÃ¶z FarÄ± 07 On Top	COL name VAL L'oreal paris Tekli GÃ¶z FarÄ± - Color Queen Mono Eyeshadow 07 On Top 30173057	1
COL name VAL L'OrÃ©al Paris Infaillible Lip Paint Likit Ruj Matte 201 Hollywood Beige- Nude	COL name VAL L'oreal paris Likit Mat Ruj - Infaillible Lip Paint Matte 201 Hollywood Beige	1
COL name VAL L'oreal paris Likit Mat Ruj - Rouge Signature 116 I Explore	COL name VAL L'OrÃ©al Paris Rouge Signature Likit Mat Ruj - 116 I explore	1
COL name VAL L'oreal paris L'orÃ©al Paris Bambi Eye Oversized Ceylan GÃ¶z Etkili Maskara - Siyah	COL name VAL Loreal Paris L'orÃ©al Paris Bambi Eye Extra Black Ceylan GÃ¶z Etkili Maskara - Ekstra Siyah	0
COL name VAL L'OrÃ©al Paris Color Riche Dudak Kalemi 302 BOIS DE ROSE- Nude	COL name VAL L'oreal paris Dudak Kalemi - Color Riche Crayon Liner 302 Bois De Rose	1
COL name VAL L'OrÃ©al Paris Rouge Signature Likit Mat Ruj - 117 I Stand	COL name VAL L'oreal paris Rouge Signature Likit Mat Ruj 117 I Stand	1
COL name VAL Loreal Paris Tekli GÃ¶z FarÄ± - Color Queen Mono Eyeshadow 12 Fighter 30173101	COL name VAL L'oreal paris Tekli GÃ¶z FarÄ± - Color Queen Mono Eyeshadow 20 Queen 30173187	0
COL name VAL L'oreal paris Color Riche Les Nus Ruj 182 Nu Extreme	COL name VAL L'OrÃ©al Paris Color Riche Les Nus Ruj 182 Nu Extreme	0
COL name VAL Loreal expert Loreal Paris Infaillible 24h FondÃ¶ten 145 Beige Rose	COL name VAL L'OrÃ©al Paris Infaillible 24H FondÃ¶ten 145 ROSE BEIGE	0
COL name VAL L'oreal paris Infaillible TÃ¼m YÃ¼ze Uygulanabilir KapatÄ±cÄ± 322 Ivory	COL name VAL L'OrÃ©al Paris Infaillible TÃ¼m YÃ¼ze Uygulanabilir KapatÄ±cÄ± 338 Honey	0
COL name VAL L'oreal paris L'orÃ©al Paris Bambi Eye Oversized Ceylan GÃ¶z Etkili Maskara - Siyah	COL name VAL L'orÃ©al Paris Bambi Eye Ceylan GÃ¶z Etkili Maskara, Siyah, 8.9 ml	0
COL name VAL L'oreal paris Likit Mat Ruj - Rouge Signature 113 I Don't	COL name VAL L'Oreal Paris Rouge Signature Matte Likit Ruj 113 Dont	1
COL name VAL L'oreal paris Pudra - True Match Powder N4 Beige	COL name VAL L'Oreal Paris True Match Pudra N4 Beige	1
COL name VAL L'OrÃ©al Paris Paradise Suya DayanÄ±klÄ± Siyah Maskara	COL name VAL L'OrÃ©al Paris Paradise Suya DayanÄ±klÄ± Siyah Maskara	1
COL name VAL L'oreal paris Bambi Eye Ceylan GÃ¶z Etkili Siyah Maskara	COL name VAL L'OrÃ©al Paris Bambi Eye Ceylan GÃ¶z Etkili Maskara - Siyah	0
COL name VAL Loreal Paris L'orÃ©al Paris Lash Paradise Intense Black Ekstra Siyah Maskara	COL name VAL L'oreal paris Lash Paradise Intense Black Ekstra Siyah Maskara 6.4ml	0
COL name VAL L'oreal paris Mat Ruj - Color Riche Matte Addiction 358 Lava	COL name VAL L'OrÃ©al Paris Color Riche Matte Addiction Ruj 358 Lava - KÄ±rmÄ±zÄ±	1
COL name VAL L'oreal paris Glow Mon Amour Droplet Highlight 03 Bronze In Love Likit AydÄ±nlatÄ±cÄ±	COL name VAL L'OrÃ©al Paris Glow Mon Amour Likit AydÄ±nlatÄ±cÄ± 03 Bronze In Love	1
COL name VAL L'OrÃ©al Paris Infaillible Metallic Lip Paint 306 Lolita	COL name VAL L'oreal paris Ruj - Lip Paint Metallic 306 Lolita	1
COL name VAL L'OrÃ©al Paris Infaillible 24H FondÃ¶ten 220 SAND	COL name VAL L'oreal paris L'OrÃ©al Paris Infaillible 32H Fresh Wear C Vitaminli FondÃ¶ten - 220 Sand	1
COL name VAL L'oreal paris L'orÃ©al Paris True Match BakÄ±m Yapan FondÃ¶ten 1r Rose Ivory & True Match KapatÄ±cÄ± 1n Ivory	COL name VAL L'OrÃ©al Paris True Match BakÄ±m Yapan FondÃ¶ten 1R ROSE IVORY	0
COL name VAL L'oreal paris True Match 2+1 Vurgu BazlÄ± Pudra ParlatÄ±cÄ± Highlight 302r/302c 9g Ã–zel Koleksiyon	COL name VAL L'Oreal Paris 302RC True Match Highlight AydÄ±nlatÄ±cÄ± Pudra	1
COL name VAL L'OrÃ©al Paris True Match BakÄ±m Yapan FondÃ¶ten 3R ROSE BEIGE	COL name VAL L'oreal paris True Match BakÄ±m Yapan FondÃ¶ten 3r Rose BeÄ±ge	1
COL name VAL L'OrÃ©al Paris Infaillible TÃ¼m YÃ¼ze Uygulanabilir KapatÄ±cÄ± 332 Amber	COL name VAL L'oreal paris TÃ¼m YÃ¼ze Uygulanabilir KapatÄ±cÄ± - Infaillible More Than Concealer 332 Amber 30173422	1
COL name VAL L'oreal paris Likit Mat Ruj - Les Chocolats Ultra Matte Liquid Lipstick 844 Sweet Tooth	COL name VAL L'Oreal Paris Les Chocolats Ultra Matte Likit Mat Ruj 844 Sweet Tooth	1
COL name VAL L'OrÃ©al Paris True Match BakÄ±m Yapan FondÃ¶ten 3N Creamy BeÄ±ge	COL name VAL L'oreal paris True Match BakÄ±m Yapan FondÃ¶ten 4n BeÄ±ge	0
COL name VAL L'OrÃ©al Paris True Match BakÄ±m Yapan FondÃ¶ten 1.5 LÄ±nen	COL name VAL L'oreal paris L'orÃ©al Paris True Match BakÄ±m Yapan FondÃ¶ten 5n Sand	0
COL name VAL L'oreal paris True Match BakÄ±m Yapan FondÃ¶ten 6D GOLDEN HONEY	COL name VAL L'OrÃ©al Paris True Match BakÄ±m Yapan FondÃ¶ten 6D Golden Honey	1
COL name VAL L'oreal paris L'orÃ©al Paris Color Riche Plump & Shine Ruj	COL name VAL L'OrÃ©al Paris Color Riche Plump & Shine Ruj 102 Watermelon Plump	1
COL name VAL L'Oreal Paris InfaÄ±llÄ±ble Gel Crayon 24h Eyeliner 11 Purple	COL name VAL L'OrÃ©al Paris Infaillible Paint Gel Crayon Eyeliner 11 Vava Voum Violet	1
COL name VAL L'oreal paris Stick AydÄ±nlatÄ±cÄ± - Infaillible Shaping Stick 501 Oh my Jewels	COL name VAL L'OrÃ©al Paris Infaillible Shaping Stick AydÄ±nlatÄ±cÄ± 501 Oh my Jewels	1
COL name VAL L'oreal paris Ruj - Lip Paint Metallic 305 Cute But	COL name VAL L'OrÃ©al Paris Infaillible Metallic Lip Paint 305 Cute But Psycho	1
COL name VAL L'oreal paris Color Riche Shine Naked Tans Ruj 658 Topless - Nude	COL name VAL L'OrÃ©al Paris Color Riche Shine Naked Tans Ruj 659 Blow Your Glow - Nude	1
COL name VAL L'Oreal Paris Infaillible Eye Paint GÃ¶z FarÄ± 102 Irresistible	COL name VAL L'OrÃ©al Paris Infaillible Eye Paint GÃ¶z FarÄ± 102 Irresistible Rose	1
COL name VAL L'oreal paris KapatÄ±cÄ± - True Match Concealer 1N Ivory	COL name VAL L'OrÃ©al Paris True Match KapatÄ±cÄ± 1N Ivory	1
COL name VAL L'oreal paris Likit Mat Ruj - Infaillible Lip Paint Lacquer 101 Gone With Nude	COL name VAL L'OrÃ©al Paris Infaillible Lip Paint Likit Ruj Lacquer 101 Gone with the Nude	1
COL name VAL L'OrÃ©al Paris Color Riche Matte Addiction Ruj 471 Voodoo - Mor	COL name VAL L'oreal paris Mat Ruj - Color Riche Matte Addiction 471 Voodoo	1
COL name VAL Loreal Paris L'orÃ©al Paris Air Volume Mega Easy Waterproof Suya DayanÄ±klÄ± Maskara - Siyah	COL name VAL L'oreal paris L'orÃ©al Paris Air Volume Mega Easy Waterproof Suya DayanÄ±klÄ± Maskara - Siyah	0
COL name VAL L'OrÃ©al Paris Rouge Signature Likit Mat Ruj - 114 I represent	COL name VAL L'Oreal Paris Rouge Signature Matte Likit Ruj 114 Represent	1
COL name VAL L'OrÃ©al Paris True Match BakÄ±m Yapan FondÃ¶ten 6.5D Golden Toffee	COL name VAL L'oreal paris L'orÃ©al Paris True Match BakÄ±m Yapan FondÃ¶ten 5d Golden Sand	0
COL name VAL L'OrÃ©al Paris Color Queen Tekli GÃ¶z FarÄ± 26 Stunner	COL name VAL L'oreal paris Loreal Color Queen Tekli GÃ¶z FarÄ± 26 Stunner	1
COL name VAL L'oreal paris Mavi Eyeliner - Infaillible Gel Crayon Eyeliner 10 Blue	COL name VAL L'Oreal Paris InfaÄ±llÄ±ble Gel Crayon 24h Eyeliner 10 Blue	1
COL name VAL L'oreal paris Siyah Eyeliner - Infallible Superliner Black velvet	COL name VAL L'OrÃ©al Paris Superliner Black Velvet Eyeliner	1
COL name VAL L'orÃ©al Paris Infaillible Matte Lip Crayon Kalem Mat Ruj - 110 Caramel Rebel 1 Paket (1 X 1	COL name VAL L'oreal paris Infaillible Matte Lip Crayon Kalem Mat Ruj - 110 Caramel Rebel	0
COL name VAL L'oreal paris True Match BakÄ±m Yapan FondÃ¶ten 4.5n True BeÄ±ge	COL name VAL L'oreal Paris True Match BakÄ±m Yapan FondÃ¶ten 5n Sand FondÃ¶ten	0
COL name VAL L'OrÃ©al Paris Ã‡ift FazlÄ± Micellar Kusursuz Makyaj Temizleme Suyu	COL name VAL L'oreal paris Ã‡ift FazlÄ± Micellar Kusursuz Makyaj Temizleme Suyu 400 Ml	1
COL name VAL L'oreal paris AydÄ±nlatÄ±cÄ± Paleti 02 Cool Glow+lionesse Barbie Makyaj FÄ±rÃ§asÄ± 002	COL name VAL Loreal Paris AydÄ±nlatÄ±cÄ± Paleti 02 Cool Glow+Lionesse Barbie Makyaj FÄ±rÃ§asÄ± 010	0
COL name VAL L'oreal paris Infallible Stylo Eyeliner 16h 300 Chocolate Addict Kahverengi Eyeliner -	COL name VAL L'OrÃ©al Paris Infaillible 24H GÃ¶z Kalemi 300 CHOCOLATE ADDICTION	1
COL name VAL L'oreal paris Bambi Eye Ceylan GÃ¶z Etkili Siyah Maskara 30175792	COL name VAL Loreal Paris Bambi Eye Ceylan GÃ¶z Etkili Maskara Siyah x 2	0
COL name VAL L'oreal paris True Match BakÄ±m Yapan FondÃ¶ten 4.5n True BeÄ±ge	COL name VAL Loreal Paris L'oreal Paris True Match BakÄ±m Yapan FondÃ¶ten 4n Beige	0
COL name VAL L'oreal paris Tekli GÃ¶z FarÄ± - Color Queen Mono Eyeshadow 26 Stunner 30173248	COL name VAL L'OrÃ©al Paris Color Queen Tekli GÃ¶z FarÄ± 26 Stunner	1
COL name VAL L'oreal paris Infaillible 24h Fresh Wear Pudra FondÃ¶ten 220 Sand	COL name VAL L'OrÃ©al Paris Infaillible 24H Fresh Wear Pudra FondÃ¶ten 220 Sand	1
COL name VAL L'OrÃ©al Paris Paradise Suya DayanÄ±klÄ± Siyah Maskara	COL name VAL L'oreal paris L'orÃ©al Paris Paradise Suya DayanÄ±klÄ± Siyah Maskara	1
COL name VAL L'OREAL PARÄ°S SÄ°YAH TELESCOPÄ°C MASKARA	COL name VAL L'oreal paris Siyah Telescopic Maskara	1
COL name VAL L'oreal paris Likit Mat Ruj - Les Macarons Ultra Matte Liquid Lipstick 818 Dose Of Ros	COL name VAL L'orÃ©al Paris Les Macarons Likit Mat Ruj 818 Dose Of Rose	1
COL name VAL Loreal Paris Paradise Intense Black Ekstra Siyah Maskara x 2	COL name VAL L'oreal paris Lash Paradise Intense Black Ekstra Siyah Maskara	0
COL name VAL Loreal Paris L'orÃ©al Paris Unlimited Siyah Maskara 2'li Set 1 Paket (1 x 2 Adet)	COL name VAL L'oreal paris Unlimited Siyah Maskara 2'li Set + Ayna	0
COL name VAL L'OrÃ©al Paris Rouge Signature Likit Mat Ruj - 105 I Rule	COL name VAL L'Oreal Paris Rouge Signature Matte Likit Ruj 105 Rule	1
COL name VAL L'oreal paris AllÄ±k - Skin Awakening Blush 01 Life's A Peach	COL name VAL Loreal Paris AllÄ±k - Skin Awakening Blush 01 Life's A Peach	0
COL name VAL L'oreal paris Rouge Signature Parisian Sunset Likit Mat Ruj 132radiate	COL name VAL Loreal Paris L'orÃ©al Paris Rouge Signature Parisian Sunset Likit Mat Ruj, 132 I RadiateRuj	0
COL name VAL L'oreal paris Pudra - True Match Prestige Powder 3d Golden Beige	COL name VAL L'OrÃ©al Paris True Match Prestige Pudra- 3D Golden Beige	1
COL name VAL L'OrÃ©al Paris True Match KapatÄ±cÄ± - 4N Beige	COL name VAL L'oreal paris KapatÄ±cÄ± - True Match Concealer 4N Beige	1
COL name VAL Loreal Paris Loreal True Match Nude Serum FondÃ¶ten Very Light 360 FondÃ¶ten FÄ±rÃ§asÄ±	COL name VAL L'oreal paris Loreal True Match Nude Serum FondÃ¶ten Very Light FondÃ¶ten FÄ±rÃ§asÄ± Seti	0
COL name VAL L'oreal paris KadÄ±n No Color Ruj	COL name VAL L'OrÃ©al Paris Color Riche Saten BitiÅŸliRuj 125 Maison Marais - KÄ±rmÄ±zÄ±	1
COL name VAL L'oreal paris Dudak Kalemi - Infaillible Lip Pencil 701 Stay Ultraviolet	COL name VAL L'OrÃ©al Paris Infaillible Dudak Kalemi 701 Stay Ultraviolet- Pembe	1
COL name VAL L'oreal paris Bambi Eye Ceylan GÃ¶z Etkili Maskara  Siyah	COL name VAL Loreal Paris Bambi Eye Ceylan GÃ¶z Etkili Maskara - Siyah X2	0
COL name VAL Loreal Paris L'orÃ©al Paris Paradise Siyah Maskara, 6.4 ml	COL name VAL L'oreal paris Paradise Siyah Maskara	0
COL name VAL L'oreal paris Le Liner Signature Mavi GÃ¶z Kalemi 02	COL name VAL L'OrÃ©al Paris Le Liner Signature GÃ¶z Kalemi 02 Blue Jersey	1
COL name VAL L'OrÃ©al Paris True Match BakÄ±m Yapan FondÃ¶ten 5D GOLDEN SAND	COL name VAL L'oreal paris Loreal True Match Foundation 5d Golden Sand FondÃ¶ten SÃ¼ngeri Seti	1
COL name VAL Loreal Paris L'orÃ©al Paris Telescopic Maskara - Siyah 1 Paket	COL name VAL L'oreal paris Telescopic Siyah Maskara 2'li Set	0
COL name VAL L'OrÃ©al Paris Infaillible Shaping Stick FondÃ¶ten 140 Natural Rose	COL name VAL L'oreal paris Infaillible Shaping Stick FondÃ¶ten 140 Natural Rose	1
COL name VAL L'oreal paris Lash Paradise Intense Black Ekstra Siyah Maskara	COL name VAL L'oreal Paris Lash Paradise Intense Black Ekstra Siyah Maskara	1
COL name VAL L'OrÃ©al Paris True Match BakÄ±m Yapan FondÃ¶ten 2N VanÄ±lla	COL name VAL L'oreal paris True Match BakÄ±m Yapan FondÃ¶ten 2N VANILLA	1
COL name VAL Loreal Paris Telescopic Carbon Black Maskara - Siyah Maskara	COL name VAL L'oreal paris Telescopic Carbon Extra Black Maskara - Siyah	0
COL name VAL L'OrÃ©al Paris Infaillible TÃ¼m YÃ¼ze Uygulanabilir KapatÄ±cÄ± 332 Amber	COL name VAL L'oreal paris L'OrÃ©al Paris Infaillible 24H TÃ¼m YÃ¼ze Uygulanabilir KapatÄ±cÄ± - 330 Pecan	0
COL name VAL L'oreal paris Loreal Infaillible More Than Concealer KapatÄ±cÄ± 328 Lin	COL name VAL Loreal Paris - Infallible 24H Concealer - 328 Linen	1
COL name VAL L'OrÃ©al Paris Color Riche Matte Addiction Ruj 654 Bronze Sautoir - Kahverengi	COL name VAL L'oreal paris Mat Ruj Color Riche Matte Addiction 654 Bronze Sautoir	1
COL name VAL L'OrÃ©al Paris True Match Pudra C3 ROSE BEIGE	COL name VAL L'oreal paris Pudra - True Match Powder 3.R/3.C Rose Beige	1
COL name VAL L'oreal Volume Million Lashes Mascara Fatale Black	COL name VAL L'oreal paris Volume Million Lashes Fatale Maskara Siyah 9.4 ml	1
COL name VAL L'oreal paris Ruj - Color Riche Free The Nudes 06 No Hesitation	COL name VAL L'OrÃ©al Paris Color Riche Free The Nudes Ruj - No Doubts	1
COL name VAL L'orÃ©al Paris Cherie On The Cake AllÄ±k ve BronzlaÅŸtÄ±rÄ±cÄ± Pudra - 02 Dark Chocolate	COL name VAL L'oreal paris AllÄ±k & BronzlaÅŸtÄ±rÄ±cÄ± Pudra - Blush Cherie On The Cake & Bronzer 02 Dark Chocolate	1
COL name VAL L'OrÃ©al Paris Glow Mon Amour Likit AydÄ±nlatÄ±cÄ± 01 Champagne	COL name VAL L'oreal paris Paris Woke Up Like This Likit AydÄ±nlatÄ±cÄ±- Glow Mon Amour 01	1
COL name VAL L'OrÃ©al Paris Color Queen Tekli GÃ¶z FarÄ± 23 Charged	COL name VAL L'oreal paris Tekli GÃ¶z FarÄ± - Color Queen Mono Eyeshadow 23 Charged 30173217	1
COL name VAL L'oreal paris Le Linersignature Gold SarÄ± GÃ¶z Kalemi 04	COL name VAL L'OrÃ©al Paris Le Liner Signature GÃ¶z Kalemi 04 Gold Velvet	1
COL name VAL L'OrÃ©al Paris Color Riche Le Sourcil KaÅŸ Kalemi 303 Deep Brown	COL name VAL L'oreal paris Kahverengi KaÅŸ Kalemi - Brow Artist Designer Eyebrow Pencil 303 Deep Brown	1
COL name VAL L'oreal paris L'OrÃ©al Paris Infaillible 24H TÃ¼m YÃ¼ze Uygulanabilir KapatÄ±cÄ± - 330 Pecan	COL name VAL L'OrÃ©al Paris Infaillible TÃ¼m YÃ¼ze Uygulanabilir KapatÄ±cÄ± 326 Vanilla	0
COL name VAL L'Oreal Paris Ceylan GÃ¶z Etkili Ekstar Maskara Siyah + Maybelline New York Kajal GÃ¶z Kalemi	COL name VAL L'oreal paris Loreal Ceylan GÃ¶z Etkili Ekstar Siyah Maskara+maybelline Kajal GÃ¶z Kalemi	1
COL name VAL L'oreal paris Dudak Kalemi - Color Riche Crayon Liner 461 Scarlet Rouge	COL name VAL L'OrÃ©al Paris Color Riche Dudak Kalemi 461 Scarlet Rouge	1
COL name VAL L'OrÃ©al Paris Glow Mon Amour Likit AydÄ±nlatÄ±cÄ± 03 Bronze In Love	COL name VAL L'oreal paris Likit AydÄ±nlatÄ±cÄ± - Glow Mon Amour Droplet Highlight 03 Bronze In Love	1
COL name VAL L'oreal paris L'orÃ©al Paris Unbelieva Brow Micro Tatouage KaÅŸ Kalemi - 108 Dark Brunette	COL name VAL Loreal Paris Unbelieva Brow Micro Tatouage KaÅŸ Kalemi - 108 Dark Brunette	1
COL name VAL L'Oreal Paris Rouge Signature Matte Likit Ruj 113 Dont	COL name VAL L'oreal paris Likit Mat Ruj - Rouge Signature 113 I Don't	1
COL name VAL L'OrÃ©al Paris Infallible Stay Ultraviolet 701 Dudak Kalemi	COL name VAL L'oreal paris Dudak Kalemi - Infaillible Lip Pencil 701 Stay Ultraviolet	0
COL name VAL L'OrÃ©al Paris True Match FondÃ¶ten N7 Ambre	COL name VAL L'oreal paris True Match Fondation SPF17 Amber 30 ml	1
COL name VAL L'oreal paris L'OrÃ©al Paris True Match BakÄ±m Yapan FondÃ¶ten 5R ROSE SAND	COL name VAL L'orÃ©al Paris True Match BakÄ±m Yapan FondÃ¶ten 1r Rose Ivory	0
COL name VAL L'oreal paris L'OrÃ©al Paris Infaillible 24H TÃ¼m YÃ¼ze Uygulanabilir KapatÄ±cÄ± - 326 Vanilla	COL name VAL L'OrÃ©al Paris Infaillible TÃ¼m YÃ¼ze Uygulanabilir KapatÄ±cÄ± 323 Fawn	0
COL name VAL L'oreal Paris Color Riche Free The Nudes Ruj - No Pressure	COL name VAL L'oreal paris Ruj - Color Riche Free The Nudes 03 No Doubts	0
COL name VAL L'oreal paris Siyah Eyeliner - Superliner Perfect Slim	COL name VAL L'OrÃ©al Paris Superliner Perfect Slim Siyah Eyeliner	1
COL name VAL L'OrÃ©al Paris True Match BakÄ±m Yapan FondÃ¶ten - 7D Golden Amber	COL name VAL L'oreal paris L'orÃ©al Paris True Match BakÄ±m Yapan FondÃ¶ten 5d Golden Sand	0
COL name VAL L'oreal paris Micellar Makyaj Temizleme Suyu Normalden Ve Karmaya Hassas Ciltler IÃ§in	COL name VAL L'Oreal ParisÂ Micellar Makyaj Temizleme Suyu Normalden Ve Karmaya Hassas Ciltler Ä°Ã§in 200 ml	0
COL name VAL L'OrÃ©al Paris Colorista Washout Redhair	COL name VAL L'oreal paris Pudra - Infallible Powder 245 Warm Sand	1
COL name VAL L'Oreal Paris Les Macarons Ultra Matte Liquid Lipstick Ruj 820 Pral	COL name VAL L'OrÃ©al Paris Les Macarons Likit Mat Ruj 820 Praline De Paris	1
COL name VAL L'oreal paris Mat Ruj - Color Riche Matte Addiction Lipstick 430 Mon Jules	COL name VAL L'OrÃ©al Paris Color Riche Matte Addiction Ruj 430 Mon Jules - Bordo	1
COL name VAL Loreal Paris Infallible Longwear Lip Liner 205 Apocalypse Red	COL name VAL Loreal botanicals Loreal Paris Infallible Longwear Lip Liner 205 Apocalypse Red	0
COL name VAL L'OrÃ©al Paris Bonjour Nudista AydÄ±nlÄ±k Veren Renkli Nemlendirici 04 Medium Dark - Koyu Ton	COL name VAL L'oreal paris BB Krem - Bonjour Nudista BB Cream 04 Medium Dark	1
COL name VAL L'oreal paris Ruj - Infallible Sexy Balm 201 Wasted	COL name VAL L'OrÃ©al Paris Infaillible Sexy Balm Ruj 201 WASTED	1
COL name VAL L'oreal paris Mat Pudra - Infaillible 24H Ultra Matte Prestige Pudra 160 Sand Beige	COL name VAL L'OrÃ©al Paris Infaillible 24H Ultra Matte Prestige Pudra-160 Sand Beige	1
COL name VAL L'oreal paris Likit Mat Ruj - Les Macarons Ultra Matte Liquid Lipstick 828 Framboise Frenzy	COL name VAL L'OrÃ©al Paris Les Macarons Likit Mat Ruj 828 Framboise Frenzy	1
COL name VAL L'OrÃ©al Paris Infaillible 24H Matte Cover YÃ¼ksek KapatÄ±cÄ± FondÃ¶ten - 90 Rose Porcelain	COL name VAL L'oreal paris Infaillible 24h Matte Cover YÃ¼ksek KapatÄ±cÄ± FondÃ¶ten 155 Natural Rose	0
COL name VAL L'oreal paris Ruj - Color Riche Free The Nudes 04 No Cage	COL name VAL Loreal Paris L'orÃ©al Paris Color Riche Free The Nudes Ruj - No Cliche	0
COL name VAL L'oreal paris Bronz Pudra - Glam Bronze Powder 04	COL name VAL Loreal Paris Glam Bronze Powder 04	1
COL name VAL L'oreal paris True Match BakÄ±m Yapan FondÃ¶ten 1D GOLDEN IVORY	COL name VAL L'OrÃ©al Paris True Match BakÄ±m Yapan FondÃ¶ten 1R ROSE IVORY	0
COL name VAL L'OrÃ©al Paris Infaillible 24H FondÃ¶ten 140 BEIGE DORE	COL name VAL L'oreal paris Uzun SÃ¼re KalÄ±cÄ± FondÃ¶ten - Infallible 24H Foundation 140 Beige Dore 30 ml	1
COL name VAL L'orÃ©al Paris Air Mega Volume Maskara - 30 Saate Kadar KalÄ±cÄ± - Ekstra Siyah	COL name VAL L'oreal paris Air Mega Volume Maskara -30 Saate Kadar KalÄ±cÄ± - Ekstra Siyah +pastel KalÄ±cÄ± Ruj No 15	0
COL name VAL L'oreal paris Likit Mat Ruj - Rouge Signature 113 I Don't	COL name VAL L'Oreal Paris Rouge Signature Matte Likit Ruj 113 Dont	1
COL name VAL L'oreal paris True Match BakÄ±m Yapan FondÃ¶ten 2N VANILLA	COL name VAL L'OrÃ©al Paris True Match BakÄ±m Yapan FondÃ¶ten - 2N Vanilla	1
COL name VAL L'oreal paris Color Riche Safari Woman Mat Ruj 648 Glamazone	COL name VAL L'OrÃ©al Paris Color Riche x Balmain Collection Safari Woman Mat Ruj 648 Glamazone	1
COL name VAL L'oreal paris Tekli GÃ¶z FarÄ± - Color Queen Mono Eyeshadow 06 Ferocious 30173040	COL name VAL L'OrÃ©al Paris Color Queen Tekli GÃ¶z FarÄ± 06 Ferocious	1
COL name VAL L'OrÃ©al Paris Color Queen Tekli GÃ¶z FarÄ± 17	COL name VAL L'oreal paris Tekli GÃ¶z FarÄ± - Color Queen Mono Eyeshadow 17 Don't Stop Me 30173156	1
COL name VAL L'OrÃ©al Paris Le Liner Signature GÃ¶z Kalemi 09 Turquoise Faux Fur	COL name VAL L'oreal paris Le Liner Signature Mavi GÃ¶z Kalemi 09	1
COL name VAL L'oreal paris Pudra - Infallible Powder 245 Warm Sand	COL name VAL L'OrÃ©al Paris Colorista Washout Redhair	1
COL name VAL Loreal Paris Loreal FondÃ¶ten Paris Infaillible 24H Matte Cover YÃ¼ksek KapatÄ±cÄ± FondÃ¶ten No: 290 Golden Amber	COL name VAL L'oreal paris Infaillible 24h Matte Cover YÃ¼ksek KapatÄ±cÄ± FondÃ¶ten 115 Golden Beige	0
COL name VAL Loreal Paris Paradise Makyaj Seti	COL name VAL L'oreal paris Paradise Makyaj Seti	1
COL name VAL L'oreal paris True Match BakÄ±m Yapan FondÃ¶ten 8R NUT BROWN	COL name VAL L'OrÃ©al Paris True Match BakÄ±m Yapan FondÃ¶ten 8R Nut Brown	1
COL name VAL L'oreal paris Ruj - Color Riche Free The Nudes 03 No Doubts	COL name VAL L'OrÃ©al Paris Color Riche Free The Nudes Ruj - No Hesitation	1
COL name VAL L'orÃ©al Paris True Match BakÄ±m Yapan FondÃ¶ten 1r Rose Ivory	COL name VAL L'oreal paris L'orÃ©al Paris True Match BakÄ±m Yapan FondÃ¶ten 7r Rose Amber	0
COL name VAL L'OrÃ©al Paris Infaillible 24H FondÃ¶ten 230 RADIANT HONEY	COL name VAL L'oreal paris Uzun SÃ¼re KalÄ±cÄ± FondÃ¶ten - Infallible 24H Foundation 230 Golden 30 ml	1
COL name VAL L'oreal paris L'orÃ©al Paris True Match BakÄ±m Yapan FondÃ¶ten 5n Sand	COL name VAL L'OrÃ©al Paris True Match BakÄ±m Yapan FondÃ¶ten 5R ROSE SAND	0
COL name VAL L'oreal paris Loreal Color Queen Tekli GÃ¶z FarÄ± 20 Queen	COL name VAL Loreal Paris Color Queen Tekli GÃ¶z FarÄ± 34 Gilded	0
COL name VAL L'oreal paris True Match BakÄ±m Yapan FondÃ¶ten 2d Golden Almond	COL name VAL L'OrÃ©al Paris True Match BakÄ±m Yapan FondÃ¶ten 2D Golden Almond	1
COL name VAL L'oreal Paris True Match BakÄ±m Yapan FondÃ¶ten 1n Ivory FondÃ¶ten	COL name VAL L'oreal paris L'OrÃ©al Paris True Match BakÄ±m Yapan FondÃ¶ten 1.5 Linen	0
COL name VAL Loreal Paris Ruj Kalem Matte LÄ±p Crayon 110 Caramel Rebel	COL name VAL L'oreal paris Infaillible Matte Lip Crayon Kalem Mat Ruj - 110 Caramel Rebel	1
COL name VAL L'oreal paris Kahverengi Eyeliner - Infallible Stylo Eyeliner 16H 300 Chocolate Addict	COL name VAL L'Oreal Paris 24 Saat KalÄ±cÄ± Kalem No 300	1
COL name VAL L'OrÃ©al Paris Color Riche Plump & Shine Ruj 108 Wild Fig Plump	COL name VAL L'oreal paris L'orÃ©al Paris Color Riche Plump & Shine Ruj	0
COL name VAL L'OrÃ©al Paris Infaillible TÃ¼m YÃ¼ze Uygulanabilir KapatÄ±cÄ± 332 Amber	COL name VAL L'oreal paris L'OrÃ©al Paris Infaillible TÃ¼m YÃ¼ze Uygulanabilir KapatÄ±cÄ± 338 Honey	0
COL name VAL L'Oreal Paris True Match BakÄ±m Yapan FondÃ¶ten 1d Golden Ivory	COL name VAL L'Oreal Paris True Match BakÄ±m Yapan FondÃ¶ten 1D Golden Ivory	1
COL name VAL Loreal Paris True Match Nude Serum FondÃ¶ten 0.5-2 Very Light	COL name VAL L'oreal paris L'orÃ©al Paris True Match Nude FondÃ¶ten Serum 0.5-2 Very Light	1
COL name VAL L'OrÃ©al Paris Infaillible 24H Matte Cover YÃ¼ksek KapatÄ±cÄ± FondÃ¶ten - 25 Rose Ivory	COL name VAL L'oreal paris Infaillible 24h Matte Cover YÃ¼ksek KapatÄ±cÄ± FondÃ¶ten 25 Rose Ivory	1
COL name VAL L'OrÃ©al Paris Merry Metals Superliner 03 Gold	COL name VAL L'oreal paris Merry Metals Superliner 03 Gold Eyeliner -3600523515752	1
COL name VAL L'OrÃ©al Paris Infaillible Sexy Balm Ruj 203 YALA YOLO	COL name VAL L'oreal paris Ruj - Infallible Sexy Balm 203 Yala Yolo	1
COL name VAL L'Oreal Paris Paradise Su BazlÄ± Renkli Nemlendirici 03 Fair	COL name VAL L'oreal paris Paradise Su BazlÄ± Renkli Nemlendirici 03 Fair	1
COL name VAL L'oreal paris Telescopic Carbon Black Maskara - Siyah & Infaillible 24h Fresh Wear Pudra FondÃ¶ten 120 Vanilla	COL name VAL Loreal Paris Telescopic Gold Siyah Maskara & Infaillible 24H Fresh Wear Pudra FondÃ¶ten 120 Vanilla	0
COL name VAL L'oreal paris Ruj - Color Riche Lipstick 703 Oud Obsession	COL name VAL L'OrÃ©al Paris Color Riche Ruj 703 OUD OBSESSION	1
COL name VAL L'oreal paris Siyah Maskara - Miss Manga	COL name VAL L'OrÃ©al Paris Mega Volume Miss Manga Maskara	1
COL name VAL L'oreal paris Bambi Oversized Eye Maskara Siyah + GÃ¶z Kalemi	COL name VAL L'OrÃ©al Paris Bambi Oversized Eye Maskara - Siyah	0
COL name VAL L'OrÃ©al Paris Infaillible 24H Fresh Wear Pudra FondÃ¶ten 220 Sand	COL name VAL L'oreal paris Infaillible 24h Fresh Wear Pudra FondÃ¶ten 220 Sand	1
COL name VAL L'OrÃ©al Paris Paradise Siyah Maskara	COL name VAL L'oreal paris Siyah  Paradise Maskara	1
COL name VAL L'OrÃ©al Paris True Match Nude FondÃ¶ten Serum 2-3 Light	COL name VAL L'oreal paris L'orÃ©al Paris True Match Nude FondÃ¶ten Serum 3-4 Light Medium	0
COL name VAL L'oreal paris Mat Pudra - Infaillible 24H Ultra Matte Prestige Pudra 225 Beige	COL name VAL L'OrÃ©al Paris Infaillible 24H Ultra Matte Prestige Pudra-225 Beige	1
COL name VAL L'OrÃ©al Paris Bronze Please! BronzlaÅŸtÄ±rÄ±cÄ± Pudra 03 Amalfi Medio	COL name VAL L'Oreal Paris Bronze BronzlaÅŸtÄ±rÄ±cÄ± Pudra Amalfi Medio 03	1
COL name VAL L'OrÃ©al Paris True Match BakÄ±m Yapan FondÃ¶ten 5N SAND	COL name VAL L'oreal paris L'orÃ©al Paris True Match BakÄ±m Yapan FondÃ¶ten 5n Sand	1
COL name VAL L'OrÃ©al Paris Color Queen Tekli GÃ¶z FarÄ± 27 Transcendent	COL name VAL L'oreal paris Tekli GÃ¶z FarÄ± - Color Queen Mono Eyeshadow 27 Transcendent 30173255	1
COL name VAL L'OrÃ©al Paris True Match BakÄ±m Yapan FondÃ¶ten 1N Ivory	COL name VAL L'oreal paris L'orÃ©al Paris True Match BakÄ±m Yapan FondÃ¶ten 1n Ivory	1
COL name VAL L'OrÃ©al Paris Color Riche Matte Addiction Ruj 652 Stone - Nude	COL name VAL L'oreal paris Mat Ruj - Color Riche Matte Addiction 652 Stone	1
COL name VAL L'oreal paris L'OrÃ©al Paris Infaillible TÃ¼m YÃ¼ze Uygulanabilir KapatÄ±cÄ± 338 Honey	COL name VAL L'OrÃ©al Paris Infaillible TÃ¼m YÃ¼ze Uygulanabilir KapatÄ±cÄ± 327 Cashmere	0
COL name VAL L'oreal paris Lash Paradise Intense Black Ekstra Siyah Maskara	COL name VAL Loreal Paris L'orÃ©al Paris Lash Paradise Intense Black Ekstra Siyah Maskara 2'li Set 1 Paket (1 x 2 Adet	0
COL name VAL L'Oreal Paris Bronze BronzlaÅŸtÄ±rÄ±cÄ± Pudra Amalfi Medio 03	COL name VAL L'oreal paris Bronze Please! BronzlaÅŸtÄ±rÄ±cÄ± Pudra 03 Amalfi	1
COL name VAL L'oreal paris Siyah Eyeliner - Infallible Eye Stylo Eyeliner 16H 301 Night Day Black	COL name VAL L'OrÃ©al Paris Infaillible 24H GÃ¶z Kalemi 301 NIGHT DAY BLACK	1
COL name VAL L'OrÃ©al Paris Infaillible Metallic Lip Paint 306 Lolita	COL name VAL L'Oreal Paris Ruj Lip Paint Metallic 306 Lolita	1
COL name VAL Loreal Paris AydÄ±nlatÄ±cÄ± Paleti 02 Cool Glow+Lionesse Barbie Makyaj FÄ±rÃ§asÄ± 010	COL name VAL L'oreal paris AydÄ±nlatÄ±cÄ± Paleti 02 Cool Glow+lionesse Barbie Makyaj FÄ±rÃ§asÄ± 002	0
COL name VAL L'oreal paris Infaillible Shaping Stick Sexy Flush AllÄ±k 001	COL name VAL L'OrÃ©al Paris Infaillible Shaping Stick AllÄ±k 001 Sexy Flush	1
COL name VAL L'oreal paris L'orÃ©al Paris Color Queen Tekli GÃ¶z FarÄ± 11 Worth It	COL name VAL L'OrÃ©al Paris Color Queen Tekli GÃ¶z FarÄ± 11 Worth It	1
COL name VAL L'oreal paris Dudak Kalemi - Infaillible Lip Pencil 105 Red Fiction	COL name VAL L'OrÃ©al Paris Infaillible Dudak Kalemi 105 Red Fiction- KÄ±rmÄ±zÄ±	1
COL name VAL L'oreal paris Telescopic Maskara - Siyah	COL name VAL Loreal Paris L'orÃ©al Paris Telescopic Maskara - Siyah 1 Paket	0
COL name VAL L'Oreal Paris Rouge Signature Matte Likit Ruj 104 Rebel	COL name VAL L'oreal paris Likit Mat Ruj Rouge Signature 104 Rebel	1
COL name VAL L'oreal paris Likit Mat Ruj - Les Macarons Ultra Matte Liquid Lipstick 824 Guava Gush	COL name VAL L'OrÃ©al Paris Les Macarons Likit Mat Ruj 824 Guava Gush	1
COL name VAL L'oreal paris L'orÃ©al Paris Superliner Gel Intenza Siyah Eyeliner	COL name VAL L'OrÃ©al Paris Superliner Gel Intenza Siyah Eyeliner	1
COL name VAL L'oreal paris L'orÃ©al Paris True Match BakÄ±m Yapan FondÃ¶ten 5d Golden Sand	COL name VAL L'OrÃ©al Paris True Match BakÄ±m Yapan FondÃ¶ten 5D Golden Sand	1
COL name VAL L'OrÃ©al Paris Rouge Signature Likit Mat Ruj - 104 I Rebel	COL name VAL L'oreal paris Likit Mat Ruj - Rouge Signature 104 Rebel	1
COL name VAL L'oreal paris Paris Waterproof Crayon Eyeliner 06 Golden	COL name VAL L'OrÃ©al Paris Infallible Waterproof Gel Crayon Eyeliner 06 Golden Woman	1
COL name VAL L'oreal paris Brow Artist Skinny Definer KaÅŸ Kalemi 108 Dark Brunette	COL name VAL L'OrÃ©al Paris Brow Artist Skinny Definer KaÅŸ Kalemi - 108 Dark Brunette	1
COL name VAL L'oreal paris Suya DayanÄ±klÄ± Siyah Eyeliner - Super Liner Black Lacquer Waterproof Eyeliner 6 ml	COL name VAL L'Oreal Paris Super LÄ±ner Black Lacquer Waterproof Eyeliner	1
COL name VAL L'OrÃ©al Paris Infallible Waterproof Gel Crayon Eyeliner 16 Navy Life	COL name VAL L'oreal paris Dudak Kalemi - Infaillible Lip PencilÂ 16 Navy Life	1
COL name VAL Loreal Paris L'oreal Paris Telescopic Carbon Siyah Maskara Maskara	COL name VAL L'oreal paris Telescopic Maskara - Siyah	0
COL name VAL L'oreal paris Emotions Of Nu AllÄ±k Far Paleti Sky Maskara Seti	COL name VAL L'Oreal Paris Emotions Of Nu AllÄ±k Far Paleti Sky Maskara Seti	1
COL name VAL L'oreal paris Ruj - Color Riche Privee Nudes - Naomi's Pink	COL name VAL L'OrÃ©al Paris Color Riche La Vie En Rose Ruj NAOMI'S PINK	1
COL name VAL L'oreal paris GÃ¶z FarÄ± Paleti - La Petite Palette Maximalist	COL name VAL L'OrÃ©al Paris La Petite Far Paleti - Maximalist	1
COL name VAL L'OrÃ©al Paris Color Riche Ruj Matte 430 Mon Jules	COL name VAL L'oreal paris Ruj - Color Riche Lipstick 430 Mon Jules	1
COL name VAL L'oreal paris Ruj - Infallible Sexy Balm 108 Whaaat	COL name VAL L'OrÃ©al Paris Infaillible Sexy Balm Ruj 108 WHAAAT?	1
COL name VAL L'oreal paris L'orÃ©al Paris True Match BakÄ±m Yapan FondÃ¶ten 1n Ivory	COL name VAL L'Oreal Paris True Match BakÄ±m Yapan FondÃ¶ten 1N IVORY	1
COL name VAL L'OrÃ©al Paris Infaillible Sculpt Palette KontÃ¼r Paleti 01 LIGHT MEDIUM	COL name VAL L'oreal paris KontÃ¼r Paleti - Infallible Sculpt Contouring Palette 01 Light	1
COL name VAL L'OrÃ©al Paris Brow Artist High Contour 109 Ebony - Esmer	COL name VAL L'oreal paris Brow Artist High Contour 109 Ebony KaÅŸ Kalemi	1
COL name VAL L'oreal Paris True Match BakÄ±m Yapan FondÃ¶ten 1n Ivory FondÃ¶ten	COL name VAL L'oreal paris True Match BakÄ±m Yapan FondÃ¶ten 1R ROSE IVORY	0
COL name VAL L'OrÃ©al Paris Infaillible TÃ¼m YÃ¼ze Uygulanabilir KapatÄ±cÄ± 326 Vanilla	COL name VAL L'oreal paris L'OrÃ©al Paris Infaillible 24H TÃ¼m YÃ¼ze Uygulanabilir KapatÄ±cÄ± - 326 Vanilla	1
COL name VAL L'OrÃ©al Paris Infaillible Lip Paint Likit Ruj Matte 202 King Pink	COL name VAL L'oreal paris Likit Mat Ruj - Infallible Lip Paint Matte 202 King Pink	1
COL name VAL L'oreal Paris Color Riche Free The Nudes Ruj - No Pressure	COL name VAL L'oreal paris Ruj - Color Riche Free The Nudes 08 No Lies	0
COL name VAL L'OrÃ©al Paris Infaillible GÃ¶zenek Gizleyici Makyaj BazÄ±	COL name VAL L'oreal paris Infaillible GÃ¶zenek Gizleyici Makyaj BazÄ±	1
COL name VAL L'oreal paris Micellar Fresh Makyaj Temizleme Suyu 400 ml	COL name VAL L'oreal Paris Micellar Makyaj Temizleme Suyu 400 Ml+ YÃ¼z Temizleme FÄ±rÃ§asÄ±	0
COL name VAL Loreal Paris True Match FondÃ¶ten 3N Creamy Beige	COL name VAL Loreal Paris True Match FondÃ¶ten 3n Creamy Beige	1
COL name VAL L'OrÃ©al Paris Infaillible Magic Setting Makyaj Sabitleyici Sprey	COL name VAL L'oreal paris Infaillible Magic Setting Makyaj Sabitleyici Sprey	1
COL name VAL L'OrÃ©al Paris Rouge Signature Metallic Likit Ruj - 203 I Magnetize	COL name VAL L'oreal paris Likit Metalik Ruj - Rouge Signature Metallic 203 I Magnetize	1
COL name VAL L'OrÃ©al Paris Color Riche Matte Addiction Ruj 430 Mon Jules - Bordo	COL name VAL L'oreal paris Mat Ruj - Color Riche Matte Addiction Lipstick 430 Mon Jules	1
COL name VAL L'OrÃ©al Paris Bambi Oversized Eye Maskara - Siyah	COL name VAL L'oreal paris Siyah Bambi Eye Oversized Ceylan GÃ¶z Etkili Maskara	1
COL name VAL L'oreal paris Mat Ruj - Infallible Matte Rouge 007 Say My Name	COL name VAL L'OrÃ©al Paris Infaillible Matte Max Ruj 007 SAY MY NAME	1
COL name VAL L'oreal paris Siyah Maskara - Volume Million Lashes Feline Mascara Black	COL name VAL L'OrÃ©al Paris Volume Million Lashes Carbon Black Maskara Siyah	0
COL name VAL L'oreal paris Likit Mat Ruj - Les Macarons Ultra Matte Liquid Lipstick 822 Mon Caramel	COL name VAL L'OrÃ©al Paris Les Macarons Likit Mat Ruj 822 Mon Caramel	1
COL name VAL L'OrÃ©al Paris True Match BakÄ±m Yapan FondÃ¶ten 9N Truffe	COL name VAL L'oreal paris L'orÃ©al Paris True Match BakÄ±m Yapan FondÃ¶ten 4n BeÄ±ge	0
COL name VAL L'OrÃ©al Paris Color Riche Collection Exclusive Doutzen' s Pure Red	COL name VAL L'oreal paris Ruj - Color Riche Exclusive Reds Doutzen's Pure Red	1
COL name VAL L'oreal paris Likit Mat Ruj - Les Macarons Ultra Matte Liquid Lipstick 830 Blackcurrant Crush 360052	COL name VAL L'Oreal Paris Les Macarons Ultra Matte Likit Ruj 830 Blackcurrant	1
COL name VAL L'oreal paris Mat Ruj - Color Riche Matte Addiction Lipstick 104 Pink Ready To We	COL name VAL L'OrÃ©al Paris Color Riche Matte Addiction Ruj 104 Strike a Rose - Pembe	1
COL name VAL L'OrÃ©al Paris True Match BakÄ±m Yapan FondÃ¶ten 3R ROSE BEIGE	COL name VAL L'oreal paris L'orÃ©al Paris True Match BakÄ±m Yapan FondÃ¶ten 7r Rose Amber	0
COL name VAL Loreal Paris Bambi Eye Ceylan GÃ¶z Etkili Maskara - Siyah X2	COL name VAL L'oreal paris Bambi Eye Ceylan GÃ¶z Etkili Siyah Maskara 30175792	0
COL name VAL L'OrÃ©al Paris True Match KapatÄ±cÄ± 3R/C Rose Beige	COL name VAL L'oreal paris KapatÄ±cÄ± - True Match Concealer 3r/c Rose Beige	1
COL name VAL L'OrÃ©al Paris Volume Million Lashes Carbon Black Maskara Siyah	COL name VAL L'oreal paris Siyah Maskara - Volume Million Lashes Feline Mascara Black	0
COL name VAL L'OrÃ©al Paris Rouge Signature Empowereds Likit Mat Ruj - 134 Empowered	COL name VAL L'oreal paris Rouge Signature Empowereds Likit Mat Ruj 134 Empowered	1
COL name VAL L'Oreal  Paris True Match BakÄ±m Yapan FondÃ¶ten 4N Beige	COL name VAL L'oreal paris L'orÃ©al Paris True Match BakÄ±m Yapan FondÃ¶ten 4n BeÄ±ge	1
COL name VAL L'oreal paris True Match BakÄ±m Yapan FondÃ¶ten 5r5c5k	COL name VAL Loreal Paris L'oreal Paris True Match BakÄ±m Yapan FondÃ¶ten 4n Beige	0
COL name VAL L'oreal paris Telescopic Mascara	COL name VAL Loreal Paris Telescopic Mascara Maskara	0
COL name VAL L'OrÃ©al Paris Infaillible TÃ¼m YÃ¼ze Uygulanabilir KapatÄ±cÄ± 323 Fawn	COL name VAL L'oreal paris Infaillible 24H TÃ¼m YÃ¼ze Uygulanabilir KapatÄ±cÄ± - 328 Lin	0
COL name VAL L'OrÃ©al Paris Color Queen Tekli GÃ¶z FarÄ± 17	COL name VAL L'oreal paris Loreal Color Queen Tekli GÃ¶z FarÄ± 20 Queen	0
COL name VAL L'OrÃ©al Paris Brow Artist Xpert No 108 Warm Brunette	COL name VAL L'oreal paris KaÅŸ Kalemi - Brow Artist Xpert 108 Warm Brune	1
COL name VAL L'oreal paris AllÄ±k - True Match Le Blush No: 120 Sandlewood	COL name VAL L'OrÃ©al Paris True Match AllÄ±k 120 SANDALWOOD PINK	1
COL name VAL L'oreal paris Color Riche Shine Naked Tans Ruj 658 Topless - Nude	COL name VAL L'OrÃ©al Paris Color Riche Shine Naked Tans Ruj 656 Beige In The City - Nude	1
COL name VAL L'oreal paris Rouge Signature Parisian Sunset Likit Mat Ruj 130Amaze	COL name VAL L'OrÃ©al Paris Rouge Signature Parisian Sunset Likit Mat Ruj - 130 I Amaze	1
COL name VAL L'oreal paris Ruj - Glam Shine Balmy Gloss 912	COL name VAL L'OrÃ©al Paris Glam Shine Balmy Gloss- 912	1
COL name VAL L'oreal paris Likit Mat Ruj - Les Chocolats Ultra Matte Liquid Lipstick 848 Dose Of Cocoa	COL name VAL L'OrÃ©al Paris Les Chocolats Likit Mat Ruj 848 Dose Of Cocoa	1
COL name VAL L'OrÃ©al Paris Color Riche Dudak Kalemi 285 PINK FEVER- Pembe	COL name VAL L'oreal paris Dudak Kalemi - Color Riche Crayon Liner 285 Pink Fever	1
COL name VAL L'OrÃ©al Paris Infaillible 24H FondÃ¶ten 125 NATURAL ROSE	COL name VAL L'oreal paris L'OrÃ©al Paris Infaillible 32H Fresh Wear C Vitaminli FondÃ¶ten - 125 Natural Beige	1
COL name VAL L'oreal paris Ruj - Color Riche Rouge Caresse Lipstick 202 Impulsive Fuschia	COL name VAL L'Oreal Paris Caresse Lipstick Ruj 202	1
COL name VAL L'OrÃ©al Paris Color Riche Dudak Kalemi 461 Scarlet Rouge	COL name VAL L'oreal paris - Color Riche Crayon Liner 461 Scarlet Rouge Dudak Kalemi	1
COL name VAL L'oreal paris Unlimited Maskara Siyah	COL name VAL L'OrÃ©al Paris Unlimited Siyah Maskara	1
COL name VAL L'oreal paris Unbelieva Brow Uzun SÃ¼re KalÄ±cÄ± KaÅŸ Jeli - 108 Dark Brunette	COL name VAL Loreal Paris Lâ€™orÃ©al Paris Uzun SÃ¼re KalÄ±cÄ± KaÅŸ Jeli Unbelieva Brow - 105 Brunette	0
COL name VAL L'oreal paris KapatÄ±cÄ± - True Match Concealer 3R/C Rose Beige	COL name VAL L'OrÃ©al Paris True Match KapatÄ±cÄ± 3R/C Rose Beige	1
COL name VAL L'oreal paris Les Chocolats Likit Mat Ruj 862 Volupto Choco	COL name VAL L'OrÃ©al Paris Les Chocolats Likit Mat Ruj 862 Volupto Choco	1
COL name VAL L'oreal paris True Match Foundation 3n Creamy Beige FondÃ¶ten	COL name VAL L'Oreal Paris FondÃ¶ten - True Match Foundation 3n Creamy Beige	1
COL name VAL L'oreal paris Normal & Karma Ve Hassas Ciltler IÃ§in Micellar Kusursuz Makyaj Temizleme Suyu 400 Ml	COL name VAL Loreal Paris L'oreal Paris Micellar Makyaj Temizleme Suyu Normalden Kuruya Hassas Ciltler IÃ§in 200 ml	0
COL name VAL L'OrÃ©al Paris Infaillible 24H Matte Cover YÃ¼ksek KapatÄ±cÄ± FondÃ¶ten - 145 Rose Beige	COL name VAL L'oreal paris Infaillible 24h Matte Cover YÃ¼ksek KapatÄ±cÄ± FondÃ¶ten 145 Rose Beige	1
COL name VAL Loreal Paris Bambi Eye Ceylan GÃ¶z Etkili Maskara - Siyah X2	COL name VAL L'oreal paris Bambi Eye Ceylan GÃ¶z Etkili Maskara  Siyah	0
COL name VAL L'oreal paris Color Riche Intense Volume Matte Ruj - 603 Wood Nonchalant	COL name VAL L'orÃ©al Paris Color Riche Intense Volume Matte Ruj - 603 Wood Nonchalant	1
COL name VAL L'oreal paris VolumÄ±ssÄ±me VolumÄ±nous X5 Extra Black Extra Volume Mascara	COL name VAL L'OrÃ©al Paris Volumissime X5 Carbon Black Maskara - Siyah	1
COL name VAL L'OrÃ©al Paris True Match BakÄ±m Yapan FondÃ¶ten 1N Ivory	COL name VAL L'Oreal Paris True Match BakÄ±m Yapan FondÃ¶ten 1N IVORY	1
COL name VAL L'oreal paris Ruj - Lip Paint Metallic 306 Lolita	COL name VAL L'Oreal Paris Ruj Lip Paint Metallic 306 Lolita	1
COL name VAL L'oreal paris True Match BakÄ±m Yapan FondÃ¶ten 1D GOLDEN IVORY	COL name VAL L'OrÃ©al Paris True Match BakÄ±m Yapan FondÃ¶ten - 1D Golden Ivory	1
COL name VAL L'OrÃ©al Paris Glam Shine Lipstick 181 Riflessione	COL name VAL L'oreal paris Ruj-Glam Shine Refl.Sheer	1
COL name VAL L'OrÃ©al Paris Brow Artist High Contour 107 Cool Brunette - Koyu Kumral	COL name VAL L'oreal paris KaÅŸ Kalemi - Brow Artist High Contour 107 Cool Brown	1
COL name VAL Loreal Paris L'oreal Paris True Match BakÄ±m Yapan FondÃ¶ten 4n Beige	COL name VAL L'oreal paris True Match BakÄ±m Yapan FondÃ¶ten 3D GOLDEN BEIGE	0
COL name VAL L'oreal paris Infaillible 2-step 24 Saat KalÄ±cÄ± Likit Ruj & Balm - 312 Incessant Russet	COL name VAL Loeral Infaillable Lipstick 2 Steps 312 Incessant	1
COL name VAL L'oreal paris Pudra - True Match Powder 1.d 1.w Golden Ivory	COL name VAL L'OrÃ©al Paris True Match Pudra W1 GOLDEN IVORY	1
COL name VAL L'oreal paris True Match BakÄ±m Yapan FondÃ¶ten 4d Golden Natural	COL name VAL L'OrÃ©al Paris True Match BakÄ±m Yapan FondÃ¶ten 4D GOLDEN NATURAL	1
COL name VAL Loreal Paris Eye Paint GÃ¶z FarÄ± No: 401 Rude Boy	COL name VAL Loreal botanicals Loreal Eye Paint GÃ¶z FarÄ± No: 401 Rude Boy	0
COL name VAL L'oreal paris L'orÃ©al Paris True Match BakÄ±m Yapan FondÃ¶ten 4n BeÄ±ge	COL name VAL L'OrÃ©al Paris True Match BakÄ±m Yapan FondÃ¶ten 3N Creamy BeÄ±ge	0
COL name VAL L'OrÃ©al Paris Infaillible 24H Matte FondÃ¶ten 24 BEIGE DORE	COL name VAL L'oreal paris Infaillible 24h Matte FondÃ¶ten 24 Beige Dore	1
COL name VAL Loreal Paris L'orÃ©al Paris Mega Volume Collagene 24H Siyah Maskara	COL name VAL L'oreal paris Mega Volume Collagene 24H Siyah Maskara	0
COL name VAL L'oreal paris Mat Ruj - Color Riche Matte Addiction Lipstick 103 Rose Clutch	COL name VAL L'OrÃ©al Paris Color Riche Matte Addiction Ruj 103 Blush in a Rush - Pembe	1
COL name VAL L'OrÃ©al Paris Superstar Maskara False Lash 01 Siyah	COL name VAL L'oreal paris Siyah Maskara Lash Superstar Mascara Black 5 ml	1
COL name VAL L'OrÃ©al Paris Rouge Signature Metallic Likit Ruj - 202 I Electrify	COL name VAL L'oreal paris Likit Metalik Ruj - Rouge Signature Metallic 202 I Electrify	1
COL name VAL L'OrÃ©al Paris Infaillible MatlaÅŸtÄ±rÄ±cÄ± Makyaj BazÄ±	COL name VAL L'oreal paris MatlaÅŸtÄ±rÄ±cÄ± Makyaj BazÄ± - Infaillible Mattifying Primer	1
COL name VAL L'OrÃ©al Paris Infaillible 24H FondÃ¶ten 230 RADIANT HONEY	COL name VAL L'oreal paris L'OrÃ©al Paris Infaillible 24H FondÃ¶ten 230 RADIANT HONEY	1
COL name VAL L'oreal paris Likit Mat Ruj - Les Macarons Ultra Matte Liquid Lipstick 830 Blackcurrant Crush 360052	COL name VAL L'OrÃ©al Paris Les Macarons Likit Mat Ruj 830 Blackcurrant Crush	1
COL name VAL L'oreal paris Bambi Oversized Eye Maskara Siyah + GÃ¶z Kalemi	COL name VAL Loreal Paris Loreal Bambi Oversized Eye Siyah Maskara Kajal Kalem Seti	0
COL name VAL L'oreal paris Tekli GÃ¶z FarÄ± - Color Queen Mono Eyeshadow 36 Charmer 30173347	COL name VAL L'orÃ©al Paris Color Queen Tekli GÃ¶z FarÄ± 36 Charmer	1
COL name VAL L'oreal paris Ruj - Color Riche Free The Nudes 03 No Doubts	COL name VAL L'OrÃ©al Paris Color Riche Free The Nudes Ruj - No Doubts	1
COL name VAL L'OrÃ©al Paris Infaillible 24H GÃ¶z Kalemi 300 CHOCOLATE ADDICTION	COL name VAL L'oreal paris Kahverengi Eyeliner - Infallible Stylo Eyeliner 16H 300 Chocolate Addict	1
COL name VAL L'oreal paris True Match FondÃ¶ten 6n MÄ±el/honey	COL name VAL L'OrÃ©al Paris True Match BakÄ±m Yapan FondÃ¶ten 6N HONEY	1
COL name VAL Loeral Infaillable Lipstick 2 Steps 312 Incessant	COL name VAL L'oreal paris Infaillible 2-step 24 Saat KalÄ±cÄ± Likit Ruj & Balm - 312 Incessant Russet	1
COL name VAL L'OrÃ©al Paris True Match BakÄ±m Yapan FondÃ¶ten 3R ROSE BEIGE	COL name VAL L'oreal paris L'OrÃ©al Paris True Match BakÄ±m Yapan FondÃ¶ten 5R ROSE SAND	0
COL name VAL L'oreal paris Infaillible 24h Matte 30 Honey 35 ml Mat FondÃ¶ten -3600522875413	COL name VAL L'OrÃ©al Paris Infaillible 24H Matte FondÃ¶ten 30 Miel Honey	1
COL name VAL L'OrÃ©al Paris Infaillible Gel Crayon GÃ¶z Kalemi 10 I've Got the Blue - Mavi	COL name VAL L'oreal paris Mavi Eyeliner - Infaillible Gel Crayon Eyeliner 10 Blue	1
COL name VAL Loreal Paris Loreal FondÃ¶ten Paris Infaillible 24H Matte Cover YÃ¼ksek KapatÄ±cÄ± FondÃ¶ten No: 25 Rose Ivory	COL name VAL L'oreal paris Infaillible 24H Matte Cover YÃ¼ksek KapatÄ±cÄ± FondÃ¶ten 25 Rose Ivory	0
COL name VAL L'OrÃ©al Paris Infaillible Eye Paint GÃ¶z FarÄ± 204 Infinite Blue	COL name VAL L'oreal paris GÃ¶z FarÄ± - Infallible Eyeshadow Paint 204 Infinite Blue	1
COL name VAL L'OREAL PARÄ°S RUJ - LÄ°P PAÄ°NT METALLÄ°C 306 LOLÄ°TA	COL name VAL L'oreal paris Ruj - Lip Paint Metallic 306 Lolita	1
COL name VAL L'orÃ©al Paris Color Riche Saten BitiÅŸli Ruj 143 Pink Pigalle - Pembe	COL name VAL L'oreal paris Color Riche Ruj No 143 Pink Pigalle	1
COL name VAL L'OrÃ©al Paris True Match BakÄ±m Yapan FondÃ¶ten 4N BeÄ±ge	COL name VAL L'oreal paris L'orÃ©al Paris True Match BakÄ±m Yapan FondÃ¶ten 4n BeÄ±ge	1
COL name VAL Loreal Paris Tekli GÃ¶z FarÄ± - Color Queen Mono Eyeshadow 12 Fighter 30173101	COL name VAL L'oreal paris Tekli GÃ¶z FarÄ± - Color Queen Mono Eyeshadow 12 Fighter 30173101	1
COL name VAL L'oreal paris Ruj - Color Riche Shine Naked Tans 659 Blow Your Glow - Nude	COL name VAL L'OrÃ©al Paris Color Riche Shine Naked Tans Ruj 658 Topless - Nude	1
COL name VAL L'oreal paris GÃ¶z FarÄ± - Infallible Eyeshadow Paint 302 Immortal Black	COL name VAL L'OrÃ©al Paris Infaillible Eye Paint GÃ¶z FarÄ± 302 Immortal Black	1
COL name VAL L'oreal paris L'orÃ©al Paris La Petite Far Paleti - Fetishist	COL name VAL L'OrÃ©al Paris La Petite Far Paleti - Fetishist	1
COL name VAL L'OrÃ©al Paris Color Riche La Vie En Rose Ruj NAOMI'S PINK	COL name VAL L'oreal paris Ruj - Color Riche Privee Nudes - Naomi's Pink	1
COL name VAL L'oreal paris Telescopic Maskara - Siyah	COL name VAL L'orÃ©al Paris Telescopic Maskara - Siyah 1 Paket	0
COL name VAL L'OrÃ©al Paris Color Riche Free The Nudes Ruj - No Hesitation	COL name VAL L'oreal paris Ruj - Color Riche Free The Nudes 03 No Doubts	1
COL name VAL L'Oreal Paris Color Richa Ultra Matte Mat Ruj No: 6 Hesitation	COL name VAL L'oreal paris Ruj - Color Riche Free The Nudes 05 No Diktat	1
COL name VAL L'OrÃ©al Paris Infaillible 24H FondÃ¶ten 145 ROSE BEIGE	COL name VAL Loreal expert Loreal Paris Infaillible 24h FondÃ¶ten 145 Beige Rose	0
COL name VAL L'OrÃ©al Paris Color Riche Ruj Sevgililer ve KadÄ±nlar GÃ¼nÃ¼ Ã–zel TasarÄ±m	COL name VAL L'oreal paris Color Riche Ruj Sevgililer ve KadÄ±nlar GÃ¼nÃ¼ Ã–zel TasarÄ±m	1
COL name VAL L'oreal paris Paradise Su BazlÄ± Renkli Nemlendirici 03 Fair	COL name VAL L'Oreal Paris Paradise Su BazlÄ± Renkli Nemlendirici 03 Fair	1
COL name VAL L'oreal paris Infaillible 24H Matte Cover YÃ¼ksek KapatÄ±cÄ± FondÃ¶ten 90 Rose Porcelain	COL name VAL L'OrÃ©al Paris Infaillible 24H Matte Cover YÃ¼ksek KapatÄ±cÄ± FondÃ¶ten - 90 Rose Porcelain	1
COL name VAL L'OrÃ©al Paris Superliner Smokissime Eyeliner BROWN	COL name VAL L'oreal paris Eyeliner - Superliner Smokissime 102 Brown Smoke	1
COL name VAL L'oreal paris Ruj - Color Riche Lipstick 330 Cocorico	COL name VAL L'OrÃ©al Paris Color Riche Ruj Matte 330 Cocorico	1
COL name VAL L'OrÃ©al Paris Rouge Signature Likit Mat Ruj - 113 I don't	COL name VAL L'Oreal Paris Rouge Signature Matte Likit Ruj 113 Dont	1
COL name VAL L'oreal paris Bambi Eye Extra Black Ceylan GÃ¶z Etkili Maskara Ekstra Siyah	COL name VAL L'OrÃ©al Paris Bambi Eye Ceylan GÃ¶z Etkili Maskara - Siyah	0
COL name VAL L'oreal paris Ruj - Color Riche Free The Nudes 05 No Diktat	COL name VAL Loreal Paris L'orÃ©al Paris Color Riche Free The Nudes Ruj - No Cliche	0
COL name VAL L'orÃ©al Paris Color Riche Intense Volume Matte Ruj - 103 Blush Audace	COL name VAL L'oreal paris Color Riche Intense Volume Matte Ruj - 103 Blush Audace	1
COL name VAL L'oreal paris L'orÃ©al Paris Bambi Eye Oversized Ceylan GÃ¶z Etkili Maskara - Siyah	COL name VAL Loreal Paris L'oreal Paris Bambi Eye Ceylan GÃ¶z Etkili Maskara Eks. Siyah Maskara	0
COL name VAL L'OrÃ©al Paris Mega Volume Miss Manga Maskara	COL name VAL L'oreal paris Siyah Maskara - Miss Manga	1
COL name VAL L'OrÃ©al Paris True Match Pudra 3.R/3.C Rose Beige	COL name VAL L'oreal paris Pudra - True Match Powder 2.N Vanilla	1
COL name VAL L'OrÃ©al Paris True Match BakÄ±m Yapan FondÃ¶ten 6D Golden Honey	COL name VAL L'oreal paris L'orÃ©al Paris True Match BakÄ±m Yapan FondÃ¶ten 7d Golden Amber	0
COL name VAL L'Oreal Paris Les Macarons Ultra Matte Likit Ruj 826 Mademoise	COL name VAL L'oreal paris Likit Mat Ruj - Les Macarons Ultra Matte Liquid Lipstick 826 Mademoiselle Mango	1
COL name VAL L'oreal paris Likit Mat Ruj Rouge Signature 104 Rebel	COL name VAL L'Oreal Paris Rouge Signature Matte Likit Ruj 104 Rebel	1
COL name VAL L'oreal paris L'OrÃ©al Paris Infaillible TÃ¼m YÃ¼ze Uygulanabilir KapatÄ±cÄ± 321 Eggshell	COL name VAL L'OrÃ©al Paris Infaillible TÃ¼m YÃ¼ze Uygulanabilir KapatÄ±cÄ± 321 Eggshell	1
COL name VAL L'oreal paris L'orÃ©al Paris Brilliant Signature Plump In Gloss Ruj 402 I Soar	COL name VAL L'orÃ©al Paris Brilliant Signature Plump In Gloss Ruj 410 I Inflate	0
COL name VAL L'oreal paris L'OrÃ©al Paris Infaillible 24H TÃ¼m YÃ¼ze Uygulanabilir KapatÄ±cÄ± - 330 Pecan	COL name VAL L'OrÃ©al Paris Infaillible TÃ¼m YÃ¼ze Uygulanabilir KapatÄ±cÄ± 323 Fawn	0
COL name VAL L'OrÃ©al Paris Infallible Waterproof Gel Crayon Eyeliner 06 Golden Woman	COL name VAL L'oreal paris Infallible Waterproof Gel Crayon Eyeliner 06 Golden Woman	0
COL name VAL L'oreal paris Le Liner Signature Mor GÃ¶z Kalemi 06	COL name VAL L'OrÃ©al Paris Le Liner Signature GÃ¶z Kalemi 06 Violet Wool	1
COL name VAL L'oreal paris KaÅŸ Kalemi - Brow Artist Xpert 109 Ebony	COL name VAL L'OrÃ©al Paris Brow Artist Xpert No 109 Ebony	1
COL name VAL L'Oreal Paris True Match Pudra N4 Beige	COL name VAL L'oreal paris Pudra - True Match Powder N4 Beige	1
COL name VAL L'oreal paris KontÃ¼r Paleti - Infallible Sculpt Contouring Palette 03 Medium/Dark	COL name VAL L'OrÃ©al Paris Infaillible Sculpt Palette KontÃ¼r Paleti 01 LIGHT MEDIUM	1
COL name VAL Loreal Paris - Infallible 24H Concealer - 328 Linen	COL name VAL L'oreal paris Loreal Infaillible More Than Concealer KapatÄ±cÄ± 328 Lin	1
COL name VAL L'oreal paris Infaillible Matte Lip Crayon Kalem Mat Ruj - 103 Maple Dream	COL name VAL Loreal Paris Ruj Kalem Matte LÄ±p Crayon 103 Maple Dream	1
COL name VAL L'OrÃ©al Paris Brow Artist Paradise KaÅŸ PomadÄ± 104 Brunette - Kumral	COL name VAL L'oreal paris Jel KaÅŸ PomadÄ± - Brow Artist Pomade No: 104 Brunette 30143654	1
COL name VAL L'oreal paris Color Riche X Balmain Ruj 356 Confidence- Nude	COL name VAL L'OrÃ©al Paris Color Riche x Balmain Collection Couture Woman Mat Ruj 356 Confidence	1
COL name VAL L'oreal Paris True Match BakÄ±m Yapan FondÃ¶ten 1n Ivory FondÃ¶ten	COL name VAL L'oreal paris True Match BakÄ±m Yapan FondÃ¶ten 4.5n True BeÄ±ge	0
COL name VAL L'oreal paris Mat Eyeliner Matte Signature Eyeliner 01 Ink & KapatÄ±cÄ± 327 Cashmere	COL name VAL Loreal Paris Mat Eyeliner Matte Signature Eyeliner 01 Ink & KapatÄ±cÄ± 327 Cashmere + Organizer	0
COL name VAL L'OrÃ©al Paris True Match BakÄ±m Yapan FondÃ¶ten 7.5D Golden Chestnut	COL name VAL L'oreal paris L'orÃ©al Paris True Match BakÄ±m Yapan FondÃ¶ten 5d Golden Sand	0
COL name VAL L'Oreal Paris Les Macarons Ultra Matte Likit Ruj 830 Blackcurrant	COL name VAL L'oreal paris Likit Mat Ruj - Les Macarons Ultra Matte Liquid Lipstick 830 Blackcurrant Crush 360052	1
COL name VAL L'oreal Paris True Match BakÄ±m Yapan FondÃ¶ten 5n Sand FondÃ¶ten	COL name VAL L'oreal paris L'OrÃ©al Paris True Match BakÄ±m Yapan FondÃ¶ten 1.5 Linen	0
COL name VAL Loreal Paris L'oreal Paris Paradise Maskara Siyah Maskara	COL name VAL L'oreal paris L'orÃ©al Paris Lash Paradise Siyah Maskara	0
COL name VAL L'oreal paris Pudra - True Match Powder 2.N Vanilla	COL name VAL L'OrÃ©al Paris True Match Pudra C3 ROSE BEIGE	1
COL name VAL L'OrÃ©al Paris True Match Pudra 5.D/5.W Golden Sand	COL name VAL L'oreal paris L'orÃ©al Paris True Match Pudra W5 Golden Sand	1
COL name VAL Loreal Paris Marka: L'oreal Paris Color Riche Satin Ruj 143 Pink Pigalle Kategori: Ruj	COL name VAL L'oreal paris L'orÃ©al Paris Color Riche Satin Ruj 143 Pink Pigalle	0
COL name VAL L'Oreal Paris True Match BakÄ±m Yapan FondÃ¶ten 5D Golden Sand	COL name VAL L'OrÃ©al Paris True Match BakÄ±m Yapan FondÃ¶ten 5D Golden Sand	1
COL name VAL Loreal Paris Karl Lagerfeld Collection Far Paleti - 01	COL name VAL L'oreal paris Karl Lagerfeld Collection Far Paleti	1
COL name VAL L'oreal paris AllÄ±k & BronzlaÅŸtÄ±rÄ±cÄ± Pudra - Blush Cherie On The Cake & Bronzer Milk Chocolate 01	COL name VAL L'OrÃ©al Paris Cherie On The Cake AllÄ±k Ve BronzlaÅŸtÄ±rÄ±cÄ± Pudra 01	1
COL name VAL L'oreal paris Mat Ruj - Color Riche Matte Addiction 654 Bronze Sautoir	COL name VAL L'OrÃ©al Paris Color Riche Matte Addiction Ruj 654 Bronze Sautoir - Kahverengi	1
COL name VAL L'oreal paris Likit Makyaj BazÄ± - Infaillible Magic Essence Drops	COL name VAL L'OrÃ©al Paris Infaillible Magic Essence Drops Likit Makyaj BazÄ±	1
COL name VAL L'OrÃ©al Paris Infaillible TÃ¼m YÃ¼ze Uygulanabilir KapatÄ±cÄ± 321 Eggshell	COL name VAL L'oreal paris L'OrÃ©al Paris Infaillible TÃ¼m YÃ¼ze Uygulanabilir KapatÄ±cÄ± 321 Eggshell	1