COL name VAL L'OrÃ©al Paris Infaillible TÃ¼m YÃ¼ze Uygulanabilir KapatÄ±cÄ± 332 Amber COL category VAL Kozmetik KiÅŸisel BakÄ±m	COL name VAL L'oreal paris TÃ¼m YÃ¼ze Uygulanabilir KapatÄ±cÄ± - Infaillible More Than Concealer 332 Amber 30173422 COL category VAL nan	1
COL name VAL L'oreal paris Tekli GÃ¶z FarÄ± - Color Queen Mono Eyeshadow 27 Transcendent 30173255 COL category VAL GÃ¶z FarÄ±	COL name VAL L'OrÃ©al Paris Color Queen Tekli GÃ¶z FarÄ± 27 Transcendent COL category VAL GÃ¶z FarÄ±	1
COL name VAL L'oreal paris True Match BakÄ±m Yapan FondÃ¶ten 1R ROSE IVORY COL category VAL FondÃ¶ten	COL name VAL Loreal Paris L'oreal Paris True Match FondÃ¶ten 1R1C1K Ivory Rose COL category VAL Krem	0
COL name VAL L'oreal paris L'OrÃ©al Paris Infaillible 24H TÃ¼m YÃ¼ze Uygulanabilir KapatÄ±cÄ± - 330 Pecan COL category VAL Makyaj	COL name VAL L'OrÃ©al Paris Infaillible TÃ¼m YÃ¼ze Uygulanabilir KapatÄ±cÄ± 332 Amber COL category VAL Kozmetik KiÅŸisel BakÄ±m	0
COL name VAL L'oreal paris Bambi Eye Extra Black Ceylan GÃ¶z Etkili Maskara Ekstra Siyah COL category VAL Maskara	COL name VAL Loreal Paris L'oreal Paris Bambi Eye Ceylan GÃ¶z Etkili Maskara Eks. Siyah Maskara COL category VAL Maskara	0
COL name VAL L'oreal paris Telescopic Siyah Maskara 2'li Set COL category VAL Maskara	COL name VAL L'orÃ©al Paris Telescopic Maskara - Siyah 2'li COL category VAL Maskara	1
COL name VAL L'OrÃ©al Paris True Match Blush 235 A COL category VAL AllÄ±klar	COL name VAL L'oreal paris AllÄ±k - Blush Apricot 235 A 3600521627457 COL category VAL nan	1
COL name VAL L'oreal paris Tekli GÃ¶z FarÄ± - Color Queen Mono Eyeshadow 33 Extra 30173316 COL category VAL GÃ¶z FarÄ±	COL name VAL L'OrÃ©al Paris Color Queen Tekli GÃ¶z FarÄ± 33 Extra COL category VAL GÃ¶z FarÄ±	1
COL name VAL L'oreal paris L'orÃ©al Paris True Match BakÄ±m Yapan FondÃ¶ten 7d Golden Amber COL category VAL FondÃ¶ten	COL name VAL L'OrÃ©al Paris True Match BakÄ±m Yapan FondÃ¶ten 3D GOLDEN BEIGE COL category VAL Likit	0
COL name VAL Loreal Paris Loreal Color Riche Lipstick 163 Orange Magique COL category VAL Rujlar	COL name VAL L'oreal paris KadÄ±n 163 Orange Magique Ruj COL category VAL Dudak MakyajÄ±	1
COL name VAL L'oreal paris L'orÃ©al Paris True Match BakÄ±m Yapan FondÃ¶ten 5n Sand COL category VAL FondÃ¶ten	COL name VAL L'OrÃ©al Paris True Match BakÄ±m Yapan FondÃ¶ten 9N Truffe COL category VAL Likit	0
COL name VAL Loreal Paris Loreal Color Riche Lipstick 214 Violet Saturn COL category VAL Rujlar	COL name VAL L'oreal paris L'orÃ©al Paris Color Riche Ruj 214 Violet Saturne - Pembe COL category VAL Dudak MakyajÄ±	1
COL name VAL L'oreal paris Loreal Color Riche Lipstick 163 Orange Magique COL category VAL Dudak MakyajÄ±	COL name VAL Loreal Paris Loreal Color Riche Lipstick 163 Orange Magique COL category VAL Rujlar	0
COL name VAL L'oreal paris True Match BakÄ±m Yapan FondÃ¶ten 1D GOLDEN IVORY COL category VAL FondÃ¶ten	COL name VAL L'OrÃ©al Paris True Match BakÄ±m Yapan FondÃ¶ten - 1D Golden Ivory COL category VAL Loreal Paris FondÃ¶ten	1
COL name VAL L'oreal paris Likit Mat Ruj - Rouge Signature 104 Rebel 3600523543649 COL category VAL Dudak MakyajÄ±	COL name VAL L'OrÃ©al Paris Rouge Signature Likit Mat Ruj - 104 I Rebel COL category VAL Rujlar	1
COL name VAL L'OrÃ©al Paris Rouge Signature Lip Topper Dudak ParlatÄ±cÄ± Ruj - 212 Pure Gold COL category VAL Rujlar	COL name VAL L'oreal paris ParlatÄ±cÄ± Ruj - Rouge Signature Lip Topper 212 Pure Gold 3600523690701 COL category VAL nan	1
COL name VAL L'oreal paris IÅŸÄ±ltÄ± SaÄŸlayan FondÃ¶ten - Lumi Macique Foundation Dw5 Gold Sand 3600522075813 COL category VAL nan	COL name VAL L'OrÃ©al Paris Lumimagic DW5 SPF 18 FondÃ¶ten COL category VAL Likit	1
COL name VAL L'oreal paris Stick AydÄ±nlatÄ±cÄ± - Infaillible Shaping Stick 502 Gold is Cold 3600523533497 COL category VAL AydÄ±nlatÄ±cÄ±	COL name VAL L'OrÃ©al Paris Infaillible Shaping Stick AydÄ±nlatÄ±cÄ± 502 Gold is cold COL category VAL AydÄ±nlatÄ±cÄ±lar	1
COL name VAL L'oreal paris Lâ€™Oreal Paris Paradise Siyah Maskara + Brow Artist Paradise KaÅŸ PomadÄ± 104 Brunette-Kumral COL category VAL Makyaj	COL name VAL L'OrÃ©al Paris Brow Artist Paradise KaÅŸ PomadÄ± 104 Brunette - Kumral COL category VAL KaÅŸ MakyajÄ±	0
COL name VAL L'orÃ©al Paris Bambi Eye Oversized Ceylan GÃ¶z Etkili Maskara - Siyah COL category VAL Maskara	COL name VAL L'oreal paris L'orÃ©al Paris Bambi Eye Oversized Ceylan GÃ¶z Etkili Maskara - Siyah COL category VAL Maskara	1
COL name VAL L'oreal paris Ruj - Infallible Sexy Balm 204 Never Stop 3600523244485 COL category VAL nan	COL name VAL L'OrÃ©al Paris Infaillible Sexy Balm Ruj 204 CARPE DIEM COL category VAL Rujlar	1
COL name VAL L'oreal paris True Match BakÄ±m Yapan FondÃ¶ten 2N VANILLA COL category VAL FondÃ¶ten	COL name VAL Loreal Paris L'oreal Paris True Match BakÄ±m Yapan FondÃ¶ten 2r Rose Vanilla COL category VAL Krem	0
COL name VAL L'oreal paris Likit Mat Ruj - Les Chocolats Ultra Matte Liquid Lipstick 842 Candy Man 3600523643790 COL category VAL Dudak MakyajÄ±	COL name VAL L'Oreal Paris Les Chocolats Ultra Matte Likit Ruj 842 Candy Man COL category VAL L"Oreal Paris ParlatÄ±cÄ± & DolgunlaÅŸtÄ±rÄ±cÄ±	1
COL name VAL L'oreal paris True Match FondÃ¶ten 1r1c1k Ivory Rose COL category VAL FondÃ¶ten	COL name VAL Loreal Paris True Match FondÃ¶ten 1r Rose Ivory 30ML COL category VAL Likit	0
COL name VAL L'oreal paris Ruj - Color Riche Free The Nudes 06 No Hesitation 3600523747153 COL category VAL Dudak MakyajÄ±	COL name VAL L'Oreal Paris Color Richa Ultra Matte Mat Ruj No Doubts COL category VAL L"Oreal Paris Ruj	1
COL name VAL L'OrÃ©al Paris Mega Gloss Lip Gloss 101 GIRL ON TOP COL category VAL Dudak ParlatÄ±cÄ±larÄ±	COL name VAL L'oreal paris Ruj - Infallible Mega Gloss 101 Girl On Top 3600522995289 COL category VAL nan	1
COL name VAL L'oreal paris Volume Million Lashes Balm Brown -kahverengi Maskara -9 Ml COL category VAL Maskara	COL name VAL Loreal Paris L'oreal Paris Volume Million Lashes Balm Brown -Kahverengi Maskara COL category VAL Maskara	0
COL name VAL L'oreal paris Suya DayanÄ±klÄ± Siyah Maskara - Unlimited Very Different Waterproof Mascara Black 3600523670079 COL category VAL nan	COL name VAL L'OrÃ©al Paris Unlimited Very Different Waterproof Suya DayanÄ±klÄ± Maskara COL category VAL Maskara	1
COL name VAL L'OrÃ©al Paris Color Riche Matte Addiction Ruj 640 Erotique - Nude COL category VAL Rujlar	COL name VAL L'oreal paris Mat Ruj Color Riche Matte Addiction Lipstick 640 Erotique 3600523399932 COL category VAL nan	1
COL name VAL L'oreal paris Nemlendirme Etkili FondÃ¶ten - True Match Foundation C7 Rose Amber 30 ml 3600520457888 COL category VAL FondÃ¶ten	COL name VAL L'OrÃ©al Paris True Match FondÃ¶ten C7 Ambre Rose COL category VAL Likit	1
COL name VAL L'OrÃ©al Paris Le Liner Signature GÃ¶z Kalemi 08 Taupe Grey Tweed COL category VAL GÃ¶z Kalemi	COL name VAL L'oreal paris Le Liner Signature Mavi GÃ¶z Kalemi 08 COL category VAL GÃ¶z Kalemi	1
COL name VAL L'oreal paris L'orÃ©al Paris Paradise Suya DayanÄ±klÄ± Siyah Maskara - Waterproof COL category VAL Maskara	COL name VAL L'OrÃ©al Paris Paradise Suya DayanÄ±klÄ± Siyah Maskara COL category VAL Maskara	0
COL name VAL L'oreal paris KadÄ±n 163 Orange Magique Ruj COL category VAL Dudak MakyajÄ±	COL name VAL Loreal Paris Loreal Color Riche Lipstick 163 Orange Magique COL category VAL Rujlar	1
COL name VAL L'oreal paris Brow Artist Skinny Definer KaÅŸ Kalemi 103 Dark Blonde 3600523796830 COL category VAL KaÅŸ Kalemi&KaÅŸ FarÄ±	COL name VAL L'OrÃ©al Paris Brow Artist Skinny Definer KaÅŸ Kalemi - 103 Dark Blonde COL category VAL KaÅŸ MakyajÄ±	1
COL name VAL L'oreal paris Bronze Please! BronzlaÅŸtÄ±rÄ±cÄ± Pudra 03 Amalfi 3600522109303 COL category VAL AllÄ±k	COL name VAL L'OrÃ©al Paris Bronze Please! BronzlaÅŸtÄ±rÄ±cÄ± Pudra 03 Amalfi Medio COL category VAL AllÄ±klar	1
COL name VAL L'oreal paris AydÄ±nlatÄ±cÄ± Paleti 02 Cool Glow+lionesse Barbie Makyaj FÄ±rÃ§asÄ± 002 COL category VAL nan	COL name VAL Loreal Paris AydÄ±nlatÄ±cÄ± Paleti 02 Cool Glow+Lionesse Barbie Makyaj FÄ±rÃ§asÄ± 002 COL category VAL AydÄ±nlatÄ±cÄ±lar	0
COL name VAL Loreal Paris L'orÃ©al Paris Air Volume Mega Hacim Veren Maskara - Siyah COL category VAL Maskara	COL name VAL L'oreal paris Loreal Air Volume Mega Hacim Veren Maskara Siyah COL category VAL Maskara	1
COL name VAL L'OrÃ©al Paris Glam Bronze Duo Pudra DUO 102 COL category VAL AllÄ±klar	COL name VAL L'oreal paris Bronz Pudra - Glam Bronze Duo Powder No: 102 3600521084700 COL category VAL AllÄ±k	1
COL name VAL L'OrÃ©al Paris Paradise Siyah Maskara COL category VAL Loreal Paris Maskara & Rimel	COL name VAL L'oreal paris Paradise Siyah Maskara COL category VAL nan	1
COL name VAL L'OrÃ©al Paris True Match BakÄ±m Yapan FondÃ¶ten 2N VanÄ±lla COL category VAL Likit	COL name VAL L'oreal paris True Match BakÄ±m Yapan FondÃ¶ten 2N VANILLA COL category VAL FondÃ¶ten	1
COL name VAL L'oreal paris Kahverengi Eyeliner - Infaillible Gel Crayon Eyeliner 05 Cooper 3600523351534 COL category VAL nan	COL name VAL L'OrÃ©al Paris Infaillible Gel Crayon GÃ¶z Kalemi 05 Super Cooper - BakÄ±r COL category VAL Eyeliner	1
COL name VAL L'oreal paris L'OrÃ©al Paris Bambi Eye Ceylan GÃ¶z Etkili Maskara - Siyah COL category VAL Maskara	COL name VAL L'oreal Paris Bambi Eye Extra Black Ceylan GÃ¶z Etkili Maskara Ekstra Siyah COL category VAL Maskara	0
COL name VAL L'oreal paris Infaillible 24h Matte Cover YÃ¼ksek KapatÄ±cÄ± FondÃ¶ten 110 Rose Vanilla 3600523784400 COL category VAL FondÃ¶ten	COL name VAL L'OrÃ©al Paris Infaillible 24H Matte Cover YÃ¼ksek KapatÄ±cÄ± FondÃ¶ten - 110 Rose Vanilla COL category VAL Likit	1
COL name VAL L'oreal paris AllÄ±k Paleti - Infallible Blush Palette 01 Pink 3600523354160 COL category VAL AllÄ±k	COL name VAL L'OrÃ©al Paris Infaillible Blush Paint Palette 01 Pinks COL category VAL GÃ¶z FarÄ±	1
COL name VAL L'OrÃ©al Paris C'Ã‰st Magic Bb Krem 04 Medium COL category VAL BB Kremler	COL name VAL L'oreal paris C'Ã©st Magic BB Krem 04 Medium 3600523723485 COL category VAL BB ve CC Krem	1
COL name VAL L'oreal paris Pudra - True Match Prestige Powder 3d Golden Beige 3600523499335 COL category VAL nan	COL name VAL L'OrÃ©al Paris True Match Prestige Pudra- 3D Golden Beige COL category VAL Pudra	1
COL name VAL L'OrÃ©al Paris La Petite Far Paleti - Stylist COL category VAL GÃ¶z FarÄ±	COL name VAL L'oreal paris GÃ¶z FarÄ± Paleti - La Petite Palette Stylist 3600523556045 COL category VAL GÃ¶z FarÄ±	1
COL name VAL L'oreal paris Color Riche Intense Volume Matte Ruj - 103 Blush Audace COL category VAL Dudak MakyajÄ±	COL name VAL L'orÃ©al Paris Color Riche Intense Volume Matte Ruj - 103 Blush Audace COL category VAL Rujlar	1
COL name VAL Loreal Paris Emotions Of Nu AllÄ±k &amp; Far Paleti COL category VAL GÃ¶z FarÄ±	COL name VAL L'Oreal Paris Emotions Of Nu AllÄ±k & Far Paleti 3600523973705 COL category VAL L"Oreal Paris GÃ¶z FarÄ±	1
COL name VAL L'oreal paris Air Volume Mega Maskara COL category VAL Maskara	COL name VAL Loreal Paris L'oreal Paris Mega Air Volume Siyah Maskara 58 ml Maskara COL category VAL Maskara	0
COL name VAL L'OrÃ©al Paris Infaillible TÃ¼m YÃ¼ze Uygulanabilir KapatÄ±cÄ± 323 Fawn COL category VAL KapatÄ±cÄ±lar	COL name VAL L'oreal paris L'OrÃ©al Paris Infaillible 24H TÃ¼m YÃ¼ze Uygulanabilir KapatÄ±cÄ± - 330 Pecan COL category VAL Makyaj	0
COL name VAL Loreal Paris L'oreal Paris True Match BakÄ±m Yapan FondÃ¶ten 2r Rose Vanilla COL category VAL Krem	COL name VAL L'oreal paris True Match BakÄ±m Yapan FondÃ¶ten 2r Rose COL category VAL FondÃ¶ten	0
COL name VAL L'oreal paris Ruj - Color Riche Privee Nudes - Doutzen's Nude COL category VAL Dudak MakyajÄ±	COL name VAL Loreal Paris Ruj Color Riche Collection Privee Doutzen's Nude COL category VAL Rujlar	1
COL name VAL L'OrÃ©al Paris True Match BakÄ±m Yapan FondÃ¶ten 1D Golden Ivory COL category VAL Likit	COL name VAL L'oreal paris True Match BakÄ±m Yapan FondÃ¶ten 1n Ivory COL category VAL FondÃ¶ten	0
COL name VAL Loreal Paris L'oreal Paris True Match BakÄ±m Yapan FondÃ¶ten 2r Rose Vanilla COL category VAL Krem	COL name VAL L'oreal paris True Match BakÄ±m Yapan FondÃ¶ten 2R Rose Vanilla+True Match KapatÄ±cÄ± 2N Vanilla COL category VAL FondÃ¶ten	0
COL name VAL L'oreal Paris Lash Paradise Intense Black Ekstra Siyah Maskara COL category VAL Maskara	COL name VAL L'oreal paris Lash Paradise Intense Black Ekstra Siyah Maskara COL category VAL Maskara	1
COL name VAL L'OrÃ©al Paris Glam Shine Balmy Gloss- 912 COL category VAL Rujlar	COL name VAL L'oreal paris Ruj - Glam Shine Balmy Gloss 912 3600522371120 COL category VAL nan	1
COL name VAL L'OrÃ©al Paris Paradise Suya DayanÄ±klÄ± Siyah Maskara COL category VAL Loreal Paris Maskara & Rimel	COL name VAL L'OrÃ©al Paris Paradise Suya DayanÄ±klÄ± Siyah Maskara COL category VAL Maskara	1
COL name VAL L'oreal paris Ruj - Lip Paint Metallic 306 Lolita 3600523518289 COL category VAL Dudak MakyajÄ±	COL name VAL L'Oreal Paris Ruj Lip Paint Metallic 306 Lolita COL category VAL L"Oreal Paris Ruj	1
COL name VAL Loreal Paris MÄ±cellar COL category VAL Makyaj Temizleme ÃœrÃ¼nleri	COL name VAL L'oreal paris Micellar Makyaj Temizleme Suyu Normalden Ve Kuruya Hassas Ciltler IÃ§in 200 ml COL category VAL Makyaj Temizleyici	1
COL name VAL L'oreal paris Siyah Maskara Lash Superstar Mascara Black 5 ml 3600522833161 COL category VAL nan	COL name VAL L'OrÃ©al Paris Superstar Maskara False Lash 01 Siyah COL category VAL Maskara	1
COL name VAL L'oreal paris Kahverengi KaÅŸ Kalemi - Brow Artist Designer Eyebrow Pencil 303 Deep Brown 3600522203100 COL category VAL nan	COL name VAL L'OrÃ©al Paris Color Riche Le Sourcil KaÅŸ Kalemi 303 Deep Brown COL category VAL KaÅŸ MakyajÄ±	1
COL name VAL L'oreal paris Pudra - True Match Powder 1.d 1.w Golden Ivory 3600520772011 COL category VAL nan	COL name VAL L'OrÃ©al Paris True Match Pudra W1 GOLDEN IVORY COL category VAL Pudra	1
COL name VAL L'oreal paris Paradise Maskara 3600523822690 COL category VAL nan	COL name VAL L'OrÃ©al Paris Paradise Maskara Sevgililer ve KadÄ±nlar GÃ¼nÃ¼ Ã–zel TasarÄ±m COL category VAL Maskara	1
COL name VAL L'oreal paris Pudra - True Match Powder N4 Beige 3600520932897 COL category VAL nan	COL name VAL L'Oreal Paris True Match Pudra N4 Beige COL category VAL L"Oreal Paris Pudra	1
COL name VAL L'OrÃ©al Paris Lash Arch 4D Black Lacqu Black Mascara COL category VAL Maskara	COL name VAL L'oreal paris Koyu Siyah Maskara - Lash Architect 4D Midnight Black 3600522030126 COL category VAL nan	1
COL name VAL L'Oreal ParisÂ Micellar Makyaj Temizleme Suyu Normalden Ve Karmaya Hassas Ciltler Ä°Ã§in 200 ml COL category VAL Makyaj Temizleme ÃœrÃ¼nleri	COL name VAL L'oreal paris Micellar Makyaj Temizleme Suyu Normalden Ve Karmaya Hassas Ciltler IÃ§in COL category VAL Makyaj Temizleyici	0
COL name VAL L'oreal paris Infaillible TÃ¼m YÃ¼ze Uygulanabilir KapatÄ±cÄ± 322 Ivory COL category VAL Makyaj	COL name VAL L'OrÃ©al Paris Infaillible TÃ¼m YÃ¼ze Uygulanabilir KapatÄ±cÄ± 332 Amber COL category VAL Kozmetik KiÅŸisel BakÄ±m	0
COL name VAL L'OrÃ©al Paris Color Riche Free The Nudes Ruj - No Hesitation COL category VAL Rujlar	COL name VAL L'oreal paris Ruj - Color Riche Free The Nudes 03 No Doubts COL category VAL Dudak MakyajÄ±	1
COL name VAL Loreal Paris Bambi Eye Ceylan GÃ¶z Etkili Maskara - Siyah X2 COL category VAL Maskara	COL name VAL L'oreal paris Siyah Bambi Eye Oversized Ceylan GÃ¶z Etkili Maskara COL category VAL Maskara	0
COL name VAL L'OrÃ©al Paris Skin Perfection Cilt KusursuzlaÅŸtÄ±rÄ±cÄ± 5'I 1 Arada BB Krem Orta Ton COL category VAL BB Kremler	COL name VAL L'oreal paris BB Krem Orta Ton - Skin Perfection BB Cream Medium Spf 25 50 ml 3600522456438 COL category VAL BB ve CC Krem	1
COL name VAL L'oreal paris True Match BakÄ±m Yapan FondÃ¶ten 2d Golden Almond COL category VAL nan	COL name VAL L'OrÃ©al Paris True Match BakÄ±m Yapan FondÃ¶ten 2D Golden Almond COL category VAL Likit	1
COL name VAL L'OrÃ©al Paris Infaillible TÃ¼m YÃ¼ze Uygulanabilir KapatÄ±cÄ± 322 Ivory COL category VAL KapatÄ±cÄ±	COL name VAL L'oreal paris L'OrÃ©al Paris Infaillible 24H TÃ¼m YÃ¼ze Uygulanabilir KapatÄ±cÄ± - 330 Pecan COL category VAL Makyaj	0
COL name VAL L'OrÃ©al Paris Brow Artist High Contour 103 Warm Blond - AÃ§Ä±k SarÄ±ÅŸÄ±n COL category VAL KaÅŸ MakyajÄ±	COL name VAL L'oreal paris KaÅŸ Kalemi - Brow Artist High Contour 103 Warm Blonde 3600523601653 COL category VAL KaÅŸ Kalemi&KaÅŸ FarÄ±	1
COL name VAL L'oreal paris TÃ¼m YÃ¼ze Uygulanabilir KapatÄ±cÄ± - Infaillible More Than Concealer 332 Amber 30173422 COL category VAL nan	COL name VAL L'OrÃ©al Paris Infaillible TÃ¼m YÃ¼ze Uygulanabilir KapatÄ±cÄ± 332 Amber COL category VAL Kozmetik KiÅŸisel BakÄ±m	1
COL name VAL L'oreal paris Color Riche Shine Naked Tans Ruj 658 Topless - Nude COL category VAL nan	COL name VAL L'OrÃ©al Paris Color Riche Shine Naked Tans Ruj 659 Blow Your Glow - Nude COL category VAL Dudaklar	1
COL name VAL L'OrÃ©al Paris Color Riche Shine Ruj 466 Beauty Queen - Mor COL category VAL Rujlar	COL name VAL Loreal Paris Color Riche Shine Ruj COL category VAL Loreal Paris Ruj	1
COL name VAL L'oreal paris Dudak Kalemi - Color Riche Crayon Liner 302 Bois De Rose 3600522860747 COL category VAL Dudak Kalemi	COL name VAL L'OrÃ©al Paris Color Riche Dudak Kalemi 302 BOIS DE ROSE- Nude COL category VAL Makyaj ÃœrÃ¼nleri	1
COL name VAL L'oreal paris Ruj - Color Riche Exclusive Reds Doutzen's Pure Red 3600522760429 COL category VAL Ruj	COL name VAL L'OrÃ©al Paris Color Riche Collection Exclusive Doutzen' s Pure Red COL category VAL Rujlar	1
COL name VAL L'oreal paris Infaillible Shaping Stick 501 Oh My Jewels Stick AydÄ±nlatÄ±cÄ± -  3600523533480 COL category VAL nan	COL name VAL L'OrÃ©al Paris Infaillible Shaping Stick AydÄ±nlatÄ±cÄ± 501 Oh my Jewels COL category VAL AydÄ±nlatÄ±cÄ±lar	1
COL name VAL L'oreal paris Infaillible 24h Matte Cover YÃ¼ksek KapatÄ±cÄ± FondÃ¶ten 155 Natural Rose COL category VAL FondÃ¶ten	COL name VAL L'OrÃ©al Paris Infaillible 24H Matte Cover YÃ¼ksek KapatÄ±cÄ± FondÃ¶ten - 110 Rose Vanilla COL category VAL Likit	0
COL name VAL L'OrÃ©al Paris Infaillible Gel Crayon GÃ¶z Kalemi 03 Browny Crush - Kahverengi COL category VAL Eyeliner	COL name VAL L'oreal paris Kahverengi Eyeliner - Infaillible Gel Crayon Eyeliner 03 Brown 3600523351510 COL category VAL nan	1
COL name VAL L'oreal paris Micellar Makyaj Temizleme Suyu 200 Ml COL category VAL Makyaj Temizleyici	COL name VAL L'oreal Paris Micellar Makyaj Temizleme Suyu 400 Ml+ YÃ¼z Temizleme FÄ±rÃ§asÄ± COL category VAL Makyaj Temizleme ÃœrÃ¼nleri	0
COL name VAL L'oreal paris L'OrÃ©al Paris Bambi Eye Ceylan GÃ¶z Etkili Maskara - Siyah COL category VAL Maskara	COL name VAL Loreal Paris Bambi Eye Ceylan GÃ¶z Etkili Maskara - Siyah X2 COL category VAL Maskara	0
COL name VAL Loreal Paris L'oreal Paris Mega Air Volume Siyah Maskara 58 ml Maskara COL category VAL Maskara	COL name VAL L'oreal paris Air Volume Mega Maskara COL category VAL Maskara	0
COL name VAL L'orÃ©al Paris Bambi Eye Ceylan GÃ¶z Etkili Maskara, Siyah, 8.9 ml COL category VAL Eyeliner	COL name VAL L'oreal paris Bambi Eye Ceylan GÃ¶z Etkili Siyah Maskara 30175792 COL category VAL Maskara	0
COL name VAL L'oreal paris BB Krem AÃ§Ä±k Ton - Skin Perfection BB Cream Light Spf 25 50ml 3600522456421 COL category VAL nan	COL name VAL L'OrÃ©al Paris Skin Perfection Cilt KusursuzlaÅŸtÄ±rÄ±cÄ± 5'I 1 Arada BB Krem AÃ§Ä±k Ton COL category VAL BB Kremler	1
COL name VAL L'OrÃ©al Paris Rouge Signature Lip Topper Dudak ParlatÄ±cÄ± Ruj - 210 White Gold COL category VAL Rujlar	COL name VAL L'oreal paris Rouge Signature Lip Topper 210 White Gold ParlatÄ±cÄ± Ruj 3600523690688 COL category VAL nan	1
COL name VAL Loreal Paris L'orÃ©al Paris Infaillible TÃ¼m YÃ¼ze Uygulanabilir KapatÄ±cÄ± 327 Cashmere, 11 ml COL category VAL Krem	COL name VAL L'oreal paris Infaillible TÃ¼m YÃ¼ze Uygulanabilir KapatÄ±cÄ± 327 Cashmere COL category VAL Makyaj	0
COL name VAL L'OrÃ©al Paris True Match BakÄ±m Yapan FondÃ¶ten 6D Golden Honey COL category VAL Likit	COL name VAL L'oreal paris True Match BakÄ±m Yapan FondÃ¶ten 6D GOLDEN HONEY COL category VAL nan	1
COL name VAL L'OrÃ©al Paris True Match BakÄ±m Yapan FondÃ¶ten 4D GOLDEN NATURAL COL category VAL Likit	COL name VAL L'oreal paris True Match BakÄ±m Yapan FondÃ¶ten 4d Golden Natural COL category VAL FondÃ¶ten	1
COL name VAL Loreal Paris Bambi Eye Ceylan GÃ¶z Etkili Maskara Siyah x 2 COL category VAL Maskara	COL name VAL L'oreal paris L'OrÃ©al Paris Bambi Eye Ceylan GÃ¶z Etkili Maskara - Siyah COL category VAL Maskara	0
COL name VAL L'OrÃ©al Paris Color Riche Matte Addiction Ruj 654 Bronze Sautoir - Kahverengi COL category VAL Rujlar	COL name VAL L'oreal paris Mat Ruj Color Riche Matte Addiction 654 Bronze Sautoir 3600523584734 COL category VAL nan	1
COL name VAL Loreal Paris Karl Lagerfeld Collection Far Paleti - 01 COL category VAL GÃ¶z FarÄ±	COL name VAL L'oreal paris Karl Lagerfeld Collection Far Paleti 3600523823987 COL category VAL nan	1
COL name VAL Loreal Paris Lip Liner Couture By Color Riche 374 Intense Plum COL category VAL Dudak Kalemleri	COL name VAL Loreal botanicals Lip Liner Couture By Color Riche 374 Intense Plum COL category VAL Dudak MakyajÄ±	0
COL name VAL L'orÃ©al Paris True Match BakÄ±m Yapan FondÃ¶ten 1r Rose Ivory COL category VAL Likit	COL name VAL L'oreal paris True Match BakÄ±m Yapan FondÃ¶ten 1n Ivory COL category VAL FondÃ¶ten	0
COL name VAL L'oreal paris Likit Mat Ruj - Les Chocolats Ultra Matte Liquid Lipstick 844 Sweet Tooth 3600523643875 COL category VAL Dudak MakyajÄ±	COL name VAL L'Oreal Paris Les Chocolats Ultra Matte Likit Mat Ruj 844 Sweet Tooth COL category VAL L"Oreal Paris Ruj	1
COL name VAL L'OrÃ©al Paris Color Riche Ruj 238 ORANGE AFTER PARTY COL category VAL Rujlar	COL name VAL L'Oreal Paris Ruj No: 238 COL category VAL L"Oreal Paris Ruj	1
COL name VAL Loreal Paris Infallible Longwear Lip Liner 212 Nude-Ist COL category VAL Dudak Kalemleri	COL name VAL Loreal botanicals Loreal Paris Infallible Longwear Lip Liner 212 Nude-ist COL category VAL Dudak MakyajÄ±	0
COL name VAL L'oreal paris True Match BakÄ±m Yapan FondÃ¶ten 1D GOLDEN IVORY COL category VAL FondÃ¶ten	COL name VAL L'oreal Paris True Match BakÄ±m Yapan FondÃ¶ten 1n Ivory FondÃ¶ten COL category VAL Krem	0
COL name VAL L'OrÃ©al Paris Infaillible Nudist Eye Paint 306-Nudist COL category VAL GÃ¶z FarÄ±	COL name VAL L'oreal paris GÃ¶z FarÄ± - Infaillible Paint Nude Eyeshadow 306 Nudist 3600523482108 COL category VAL GÃ¶z FarÄ±	1
COL name VAL L'oreal paris L'OrÃ©al Paris Infaillible 24H TÃ¼m YÃ¼ze Uygulanabilir KapatÄ±cÄ± - 330 Pecan COL category VAL Makyaj	COL name VAL L'OrÃ©al Paris Infaillible TÃ¼m YÃ¼ze Uygulanabilir KapatÄ±cÄ± 323 Fawn COL category VAL KapatÄ±cÄ±lar	0
COL name VAL Loreal Paris L'orÃ©al Paris Paradise Siyah Maskara, 6.4 ml COL category VAL Maskara	COL name VAL L'oreal paris Paradise Siyah Maskara COL category VAL Maskara	0
COL name VAL L'oreal paris True Match BakÄ±m Yapan FondÃ¶ten 4D GOLDEN NATURAL COL category VAL FondÃ¶ten	COL name VAL L'OrÃ©al Paris True Match BakÄ±m Yapan FondÃ¶ten 4D GOLDEN NATURAL COL category VAL Likit	1
COL name VAL L'oreal paris Le Liner Signature Kahverengi GÃ¶z Kalemi 05 COL category VAL GÃ¶z Kalemi	COL name VAL L'OrÃ©al Paris Le Liner Signature GÃ¶z Kalemi 05 Brown Denim COL category VAL GÃ¶z Kalemi	1
COL name VAL L'OrÃ©al Paris Rouge Signature Likit Mat Ruj - 103 I Enjoy COL category VAL Rujlar	COL name VAL L'Oreal Paris Rouge Signature Matte Likit Ruj 113 Enjoy COL category VAL L"Oreal Paris ParlatÄ±cÄ± & DolgunlaÅŸtÄ±rÄ±cÄ±	1
COL name VAL L'oreal paris Tekli GÃ¶z FarÄ± - Color Queen Mono Eyeshadow 32 Commander 30173309 COL category VAL GÃ¶z FarÄ±	COL name VAL L'OrÃ©al Paris Color Queen Tekli GÃ¶z FarÄ± 32 Commander COL category VAL GÃ¶z FarÄ±	1
COL name VAL L'oreal paris Bambi Eye Ceylan GÃ¶z Etkili Siyah Maskara COL category VAL Maskara	COL name VAL L'orÃ©al Paris Bambi Eye Ceylan GÃ¶z Etkili Maskara, Siyah, 8.9 ml COL category VAL Eyeliner	0
COL name VAL L'OrÃ©al Paris Les Chocolats Likit Mat Ruj 848 Dose Of Cocoa COL category VAL Rujlar	COL name VAL L'oreal paris Likit Mat Ruj - Les Chocolats Ultra Matte Liquid Lipstick 848 Dose Of Cocoa 3600523643950 COL category VAL Dudak MakyajÄ±	1
COL name VAL L'oreal paris Ruj - Color Riche Free The Nudes 03 No Doubts COL category VAL Dudak MakyajÄ±	COL name VAL L'OrÃ©al Paris Color Riche Free The Nudes Ruj - No Diktat COL category VAL Rujlar	1
COL name VAL L'OrÃ©al Paris Les Chocolats Likit Mat Ruj 856 70% Yum COL category VAL Rujlar	COL name VAL L'oreal paris Les Chocolats Ultra Matte Liquid Lipstick 856 Yum 3600523643974 COL category VAL Dudak MakyajÄ±	1
COL name VAL L'oreal paris Paris Color Matte Addiction Ruj 473 Obsidian COL category VAL Dudak MakyajÄ±	COL name VAL L'OrÃ©al Paris Color Riche Matte Addiction Ruj 473 Obsidian - Mor COL category VAL Rujlar	1
COL name VAL L'OrÃ©al Paris True Match BakÄ±m Yapan FondÃ¶ten 4D GOLDEN NATURAL COL category VAL Likit	COL name VAL L'oreal paris True Match BakÄ±m Yapan FondÃ¶ten 4D GOLDEN NATURAL COL category VAL FondÃ¶ten	1
COL name VAL L'OrÃ©al Paris True Match - Pudra COL category VAL Pudra	COL name VAL L'oreal paris Pudra - True Match Powder 2.N Vanilla 3600523155200 COL category VAL Makyaj	1
COL name VAL L'OrÃ©al Paris Brow Artist Xpert No 109 Ebony COL category VAL KaÅŸ MakyajÄ±	COL name VAL L'oreal paris KaÅŸ Kalemi - Brow Artist Xpert 109 Ebony 3600523352876 COL category VAL nan	1
COL name VAL L'Oreal Paris Cr Ultra Matte Ruj No: 01 Obstacle COL category VAL L"Oreal Paris Ruj	COL name VAL L'oreal paris Ruj - Color Riche Free The Nudes 01 No Obstacles 3600523747146 COL category VAL Dudak MakyajÄ±	1
COL name VAL Loreal Paris L'oreal Paris Rouge Signature Likit Mat Ruj - 103 Enjoy Ruj COL category VAL Rujlar	COL name VAL L'oreal paris Rouge Signature Likit Mat Ruj COL category VAL Dudak MakyajÄ±	0
COL name VAL L'oreal paris True Match BakÄ±m Yapan FondÃ¶ten 1n Ivory COL category VAL FondÃ¶ten	COL name VAL L'OrÃ©al Paris True Match BakÄ±m Yapan FondÃ¶ten 1R ROSE IVORY COL category VAL Likit	0
COL name VAL L'oreal paris Infaillible Matte Lip Crayon Kalem Mat Ruj - 103 Maple Dream COL category VAL Dudak MakyajÄ±	COL name VAL Loreal Paris Ruj Kalem Matte LÄ±p Crayon 103 Maple Dream COL category VAL Rujlar	1
COL name VAL Loreal Paris FondÃ¶ten No 130 Visible Lift COL category VAL Likit	COL name VAL L'oreal paris Visible Lift Serum InsÄ±de Mat 100 COL category VAL FondÃ¶ten	1
COL name VAL L'oreal paris Le Liner Signature Mavi GÃ¶z Kalemi 08 COL category VAL GÃ¶z Kalemi	COL name VAL L'OrÃ©al Paris Le Liner Signature GÃ¶z Kalemi 08 Taupe Grey Tweed COL category VAL GÃ¶z Kalemi	1
COL name VAL L'OrÃ©al Paris Infaillible 24H Matte Cover YÃ¼ksek KapatÄ±cÄ± FondÃ¶ten - 130 True Beige COL category VAL Likit	COL name VAL L'oreal paris Infaillible 24h Matte Cover YÃ¼ksek KapatÄ±cÄ± FondÃ¶ten 115 Golden Beige COL category VAL FondÃ¶ten	0
COL name VAL L'OrÃ©al Paris Color Riche Matte Addiction Ruj 640 Erotique - Nude COL category VAL Rujlar	COL name VAL L'oreal paris Mat Ruj - Color Riche Matte Addiction Lipstick 640 Erotique 3600523399932 COL category VAL Dudak MakyajÄ±	1
COL name VAL L'oreal paris Ruj - Color Riche Shine Naked Tans 659 Blow Your Glow - Nude 3600523597789 COL category VAL nan	COL name VAL L'OrÃ©al Paris Color Riche Shine Naked Tans Ruj 656 Beige In The City - Nude COL category VAL Rujlar	1
COL name VAL L'OrÃ©al Paris Paradise Siyah Maskara COL category VAL Loreal Paris Maskara & Rimel	COL name VAL L'oreal paris Siyah  Paradise Maskara COL category VAL nan	1
COL name VAL L'OrÃ©al Paris Colorista Effects Balayage COL category VAL Rujlar	COL name VAL L'oreal paris Infaillible Lip Paint Likit Ruj Matte 207 Wuthering Purple COL category VAL Dudak MakyajÄ±	1
COL name VAL L'oreal paris True Match BakÄ±m Yapan FondÃ¶ten 6.5d Golden Toffee COL category VAL nan	COL name VAL L'OrÃ©al Paris True Match BakÄ±m Yapan FondÃ¶ten 5.5D Golden Sun COL category VAL Likit	0
COL name VAL L'oreal paris Rouge Signature Likit Mat Ruj 106 I Speak Up COL category VAL Dudak MakyajÄ±	COL name VAL L'OrÃ©al Paris Rouge Signature Likit Mat Ruj - 106 I Speak up COL category VAL Rujlar	1
COL name VAL L'OrÃ©al Paris Brow Artist Xpert No 107 Cool Brunette COL category VAL KaÅŸ MakyajÄ±	COL name VAL L'oreal paris KaÅŸ Kalemi - Brow Artist Xpert 107 Cool Brune 3600523352852 COL category VAL KaÅŸ Kalemi&KaÅŸ FarÄ±	1
COL name VAL L'oreal paris True Match BakÄ±m Yapan FondÃ¶ten 1n Ivory COL category VAL FondÃ¶ten	COL name VAL L'oreal Paris True Match BakÄ±m Yapan FondÃ¶ten 1n Ivory FondÃ¶ten COL category VAL Krem	1
COL name VAL L'oreal paris Super Liner Black Lacquer Waterproof Eyeliner 6 Ml 3600522025252 COL category VAL nan	COL name VAL L'OrÃ©al Paris Superliner Black Lacquer Waterproof Eyeliner - Siyah COL category VAL Eyeliner	1
COL name VAL L'oreal paris Ruj - Color Riche Lipstick 364 16 Place ven 3600522851196 COL category VAL Dudak MakyajÄ±	COL name VAL L'OrÃ©al Paris Color Riche Ruj 364 16 PLACE VENDOME COL category VAL Rujlar	1
COL name VAL Loreal Paris L'oreal Paris True Match BakÄ±m Yapan FondÃ¶ten 4n Beige COL category VAL Krem	COL name VAL L'oreal paris True Match BakÄ±m Yapan FondÃ¶ten 3R ROSE BEIGE COL category VAL FondÃ¶ten	0
COL name VAL L'OrÃ©al Paris Rouge Signature Metallic Likit Ruj - 206 I Scintillate COL category VAL Rujlar	COL name VAL L'oreal paris Likit Metalik Ruj - Rouge Signature Metallic  206 I Scintillate 3600523689590 COL category VAL Dudak MakyajÄ±	1
COL name VAL L'OrÃ©al Paris Infaillible TÃ¼m YÃ¼ze Uygulanabilir KapatÄ±cÄ± 332 Amber COL category VAL Kozmetik KiÅŸisel BakÄ±m	COL name VAL L'oreal paris L'OrÃ©al Paris Infaillible TÃ¼m YÃ¼ze Uygulanabilir KapatÄ±cÄ± 332 Amber COL category VAL nan	1
COL name VAL L'Oreal Paris Color Richa Ultra Matte Mat Ruj No Doubts COL category VAL L"Oreal Paris Ruj	COL name VAL L'oreal paris Ruj - Color Riche Free The Nudes 05 No Diktat COL category VAL Dudak MakyajÄ±	1
COL name VAL Loreal Paris L'oreal Paris True Match BakÄ±m Yapan FondÃ¶ten 2r Rose Vanilla COL category VAL Krem	COL name VAL L'oreal paris True Match BakÄ±m Yapan FondÃ¶ten 2N VANILLA COL category VAL FondÃ¶ten	0
COL name VAL L'oreal paris Siyah Eyeliner - Superliner Blackbuster 3600522333616 COL category VAL nan	COL name VAL L'OrÃ©al Paris Superliner Blackbuster Eyeliner COL category VAL Eyeliner	1
COL name VAL Loreal Paris L'oreal Paris Micellar Makyaj Temizleme Suyu Normalden Kuruya Hassas Ciltler IÃ§in 200 ml COL category VAL Makyaj Temizleme ÃœrÃ¼nleri	COL name VAL L'oreal paris Micellar Makyaj Temizleme Suyu Normalden Ve Karmaya Hassas Ciltler IÃ§in COL category VAL Makyaj Temizleyici	0
COL name VAL L'OrÃ©al Paris True Match BakÄ±m Yapan FondÃ¶ten 0.5R Rose PorcelaÄ±n COL category VAL Likit	COL name VAL L'oreal paris L'orÃ©al Paris True Match BakÄ±m Yapan FondÃ¶ten 0.5r Rose PorcelaÄ±n COL category VAL FondÃ¶ten	1
COL name VAL L'oreal paris Likit Mat Ruj - Rouge Signature COL category VAL Dudak MakyajÄ±	COL name VAL L'OrÃ©al Paris Rouge Signature Likit Mat Ruj - 116 I explore COL category VAL Rujlar	0
COL name VAL L'oreal paris L'orÃ©al Paris True Match Nude FondÃ¶ten Serum 3-4 Light Medium COL category VAL FondÃ¶ten	COL name VAL Loreal Paris True Match Nude Serum FondÃ¶ten 2-3 Light COL category VAL Likit	0
COL name VAL L'oreal paris Micellar Makyaj Temizleme Suyu 200 Ml COL category VAL Makyaj Temizleyici	COL name VAL L'OrÃ©al Paris Micellar Kusursuz Makyaj Temizleme Suyu 200 Ml COL category VAL Makyaj Temizleme ÃœrÃ¼nleri	0
COL name VAL L'Oreal Paris True Mach YaÄŸsÄ±z FondÃ¶ten N7 30 ML COL category VAL L"Oreal Paris FondÃ¶ten	COL name VAL L'OrÃ©al Paris True Match FondÃ¶ten N7 Ambre COL category VAL Likit	1
COL name VAL L'oreal paris Uzun SÃ¼re KalÄ±cÄ± FondÃ¶ten - Infaillible 24h Fresh Wear 145 Beige Rose 30 Ml 3600523614431 COL category VAL nan	COL name VAL L'OrÃ©al Paris Infaillible 24H FondÃ¶ten 145 ROSE BEIGE COL category VAL Likit	1
COL name VAL L'oreal paris True Match BakÄ±m Yapan FondÃ¶ten 1R ROSE IVORY COL category VAL FondÃ¶ten	COL name VAL L'OrÃ©al Paris True Match BakÄ±m Yapan FondÃ¶ten 1R ROSE IVORY COL category VAL Likit	0
COL name VAL L'OrÃ©al Paris Infaillible Sculpt Palette KontÃ¼r Paleti 02 MEDIUM LIGHT COL category VAL Pudra	COL name VAL L'oreal paris KontÃ¼r Paleti - Infallible Sculpt Contouring Palette 03 Medium/Dark 3600523175093 COL category VAL Makyaj	1
COL name VAL L'oreal paris Likit Mat Ruj - Les Chocolats Ultra Matte Liquid Lipstick 868 Cacao Rush 3600523643806 COL category VAL Dudak MakyajÄ±	COL name VAL L'OrÃ©al Paris Les Chocolats Likit Mat Ruj 868 Cacao Rush COL category VAL Rujlar	1
COL name VAL L'oreal paris Infaillible 24h Matte Cover YÃ¼ksek KapatÄ±cÄ± FondÃ¶ten 115 Golden Beige COL category VAL FondÃ¶ten	COL name VAL L'OrÃ©al Paris Infaillible 24H Matte Cover YÃ¼ksek KapatÄ±cÄ± FondÃ¶ten - 130 True Beige COL category VAL Likit	0
COL name VAL L'OrÃ©al Paris Glam Shine Balmy Gloss- 915 COL category VAL Rujlar	COL name VAL L'oreal paris Glam Shine Balmy Gloss- 915 COL category VAL nan	1
COL name VAL L'oreal paris FondÃ¶ten - True Match Foundation 5r Rose Sand 30 Ml 3600522862505 COL category VAL FondÃ¶ten	COL name VAL L'OrÃ©al Paris True Match BakÄ±m Yapan FondÃ¶ten 5R ROSE SAND COL category VAL Krem	1
COL name VAL L'Oreal Paris Color Richa Ultra Matte Mat Ruj No Doubts COL category VAL L"Oreal Paris Ruj	COL name VAL L'oreal paris Ruj - Color Riche Free The Nudes 06 No Hesitation 3600523747153 COL category VAL Dudak MakyajÄ±	1
COL name VAL L'OrÃ©al Paris True Match BakÄ±m Yapan FondÃ¶ten 4N BeÄ±ge COL category VAL Likit	COL name VAL L'oreal paris True Match BakÄ±m Yapan FondÃ¶ten 4.5n True BeÄ±ge COL category VAL FondÃ¶ten	0
COL name VAL L'oreal paris True Match BakÄ±m Yapan FondÃ¶ten 4.5n True BeÄ±ge COL category VAL FondÃ¶ten	COL name VAL L'Oreal Paris True Match BakÄ±m Yapan FondÃ¶ten 4.5N True Beige COL category VAL L"Oreal Paris FondÃ¶ten	1
COL name VAL L'OrÃ©al Paris True Match KapatÄ±cÄ± 3R/C Rose Beige COL category VAL KapatÄ±cÄ±lar	COL name VAL L'oreal paris KapatÄ±cÄ± - True Match Concealer 3r/c Rose Beige 3600523500215 COL category VAL nan	1
COL name VAL Loreal botanicals Loreal Eye Paint GÃ¶z FarÄ± No: 305 Peach Me Babe COL category VAL GÃ¶z FarÄ±	COL name VAL Loreal Paris Eye Paint GÃ¶z FarÄ± No: 305 Peach Me Babe COL category VAL GÃ¶z FarÄ±	0
COL name VAL L'Oreal Paris 24 Saat KalÄ±cÄ± Kalem No 300 COL category VAL L"Oreal Paris GÃ¶z Kalemi	COL name VAL L'oreal paris Kahverengi Eyeliner - Infallible Stylo Eyeliner 16H 300 Chocolate Addict 3600521663516 COL category VAL GÃ¶z MakyajÄ±	1
COL name VAL L'Oreal Paris 24 Saat KalÄ±cÄ± Kalem No 306 Stay Blue COL category VAL L"Oreal Paris GÃ¶z Kalemi	COL name VAL L'oreal paris Ä°nfaillible Eye Liner 306 Stay Blue COL category VAL nan	1
COL name VAL L'OrÃ©al Paris True Match AllÄ±k 95 ROSE IN LOVE COL category VAL AllÄ±klar	COL name VAL L'oreal paris True Match Le Blush No: 95 Rose In Love 3600522774594 COL category VAL nan	1
COL name VAL L'oreal paris Mat Ruj - Infallible Matte Rouge 008 I Gotta Feeling COL category VAL Dudak MakyajÄ±	COL name VAL L'OrÃ©al Paris Infaillible Matte Max Ruj 008 I GOTTA FEELING COL category VAL Rujlar	1
COL name VAL L'OrÃ©al Paris Bambi Oversized Eye Maskara - Siyah COL category VAL Maskara	COL name VAL L'oreal paris Siyah Bambi Eye Oversized Ceylan GÃ¶z Etkili Maskara COL category VAL Maskara	1
COL name VAL L'oreal Paris Havana By Camila Cabello Dream It GÃ¶z FarÄ± No: 03 Control COL category VAL GÃ¶z FarÄ±	COL name VAL L'oreal paris Havana By Camila Cabello Dream It GÃ¶z FarÄ± No: 03 Control COL category VAL nan	1
COL name VAL Loreal Paris L'oreal Paris Manga Mor Maskara - Tropical Violet COL category VAL Maskara	COL name VAL L'oreal paris Manga Mor Maskara - Tropical Violet 3600522424796 COL category VAL Maskara	1
COL name VAL L'OrÃ©al Paris Glow Mon Amour Likit AydÄ±nlatÄ±cÄ± 03 Bronze In Love COL category VAL AydÄ±nlatÄ±cÄ±lar	COL name VAL L'oreal paris Likit AydÄ±nlatÄ±cÄ± - Glow Mon Amour Droplet Highlight 03 Bronze In Love 3600523706747 COL category VAL nan	1
COL name VAL Loreal Paris Loreal Color Riche Lipstick 163 Orange Magique COL category VAL Rujlar	COL name VAL L'oreal paris KadÄ±n 163 Orange Magique Ruj COL category VAL Dudak MakyajÄ±	1
COL name VAL L'oreal paris Infaillible 24h Ruj 506 Red - KÄ±rmÄ±zÄ± COL category VAL Dudak MakyajÄ±	COL name VAL L'OrÃ©al Paris Infaillible 24H Ruj 506 RED INFAILLIBLE COL category VAL Rujlar	0
COL name VAL L'Oreal Paris Rouge Signature Matte Likit Ruj 104 Rebel COL category VAL L"Oreal Paris ParlatÄ±cÄ± & DolgunlaÅŸtÄ±rÄ±cÄ±	COL name VAL L'OrÃ©al Paris Rouge Signature Likit Mat Ruj - 104 I Rebel COL category VAL Rujlar	1
COL name VAL Loreal Paris Tekli GÃ¶z FarÄ± - Color Queen Mono Eyeshadow 12 Fighter 30173101 COL category VAL GÃ¶z FarÄ±	COL name VAL L'oreal paris Tekli GÃ¶z FarÄ± - Color Queen Mono Eyeshadow 12 Fighter 30173101 COL category VAL GÃ¶z FarÄ±	1
COL name VAL L'oreal paris True Match BakÄ±m Yapan FondÃ¶ten 2r Rose COL category VAL FondÃ¶ten	COL name VAL L'orÃ©al Paris True Match BakÄ±m Yapan FondÃ¶ten 1r Rose Ivory COL category VAL Likit	0
COL name VAL L'oreal paris Glow Mon Amour Droplet Highlight 03 Bronze In Love Likit AydÄ±nlatÄ±cÄ± COL category VAL AydÄ±nlatÄ±cÄ±	COL name VAL L'OrÃ©al Paris Glow Mon Amour Likit AydÄ±nlatÄ±cÄ± 03 Bronze In Love COL category VAL AydÄ±nlatÄ±cÄ±lar	1
COL name VAL L'oreal Paris True Match BakÄ±m Yapan FondÃ¶ten 5n Sand FondÃ¶ten COL category VAL Krem	COL name VAL L'oreal paris True Match BakÄ±m Yapan FondÃ¶ten 2N VANILLA COL category VAL FondÃ¶ten	0
COL name VAL L'OrÃ©al Paris Infaillible Dudak Kalemi 207 Wuthering Purple- MÃ¼rdÃ¼m COL category VAL Dudak Kalemleri	COL name VAL L'oreal paris Infaillible Dudak Kalemi 207 Wuthering Purple X2 COL category VAL Dudak MakyajÄ±	0
COL name VAL L'OrÃ©al Paris Infaillible Shaping Stick FondÃ¶ten 190 Beige Dore COL category VAL Likit	COL name VAL L'oreal paris Stick FondÃ¶ten - Infaillible Shaping Stick FondÃ¶ten 190 Beige Dore 3600523531523 COL category VAL nan	1
COL name VAL L'oreal paris True Match Le Blush No: 95 Rose In Love 3600522774594 COL category VAL nan	COL name VAL L'OrÃ©al Paris True Match AllÄ±k 95 ROSE IN LOVE COL category VAL AllÄ±klar	1
COL name VAL L'OrÃ©al Paris Infaillible 24H Matte Cover YÃ¼ksek KapatÄ±cÄ± FondÃ¶ten - 110 Rose Vanilla COL category VAL Likit	COL name VAL L'oreal paris Infaillible 24h Matte Cover YÃ¼ksek KapatÄ±cÄ± FondÃ¶ten 110 Rose Vanilla 3600523784400 COL category VAL FondÃ¶ten	1
COL name VAL L'oreal paris Infaillible Matte Lip Crayon Kalem Mat Ruj - 102 Caramel Blondie COL category VAL Dudak MakyajÄ±	COL name VAL Loreal Paris Ruj Kalem Matte LÄ±p Crayon 102 Caramel BlondÄ±e COL category VAL Rujlar	1
COL name VAL L'oreal paris Ruj - Lip Paint Metallic 306 Lolita 3600523518289 COL category VAL nan	COL name VAL L'OREAL PARÄ°S RUJ - LÄ°P PAÄ°NT METALLÄ°C 306 LOLÄ°TA COL category VAL Loreal Paris Ruj	1
COL name VAL L'oreal paris L'OrÃ©al Paris Infaillible 24H TÃ¼m YÃ¼ze Uygulanabilir KapatÄ±cÄ± - 330 Pecan COL category VAL Makyaj	COL name VAL L'OrÃ©al Paris Infaillible TÃ¼m YÃ¼ze Uygulanabilir KapatÄ±cÄ± 330 Pecan COL category VAL KapatÄ±cÄ±	0
COL name VAL Loreal Paris Smoke x Isabel Marant GÃ¶z FarÄ± Paleti 6gr COL category VAL GÃ¶z FarÄ±	COL name VAL L'oreal paris Smoke X Isabel Marant GÃ¶z FarÄ± Paleti 6gr COL category VAL nan	1
COL name VAL L'oreal paris Ruj - Color Riche Free The Nudes 02 No Cliche COL category VAL Dudak MakyajÄ±	COL name VAL L'OrÃ©al Paris Color Riche Free The Nudes Ruj - No Lies COL category VAL Rujlar	0
COL name VAL L'oreal paris L'OrÃ©al Paris Infaillible 24H TÃ¼m YÃ¼ze Uygulanabilir KapatÄ±cÄ± - 326 Vanilla COL category VAL Makyaj	COL name VAL L'OrÃ©al Paris Infaillible TÃ¼m YÃ¼ze Uygulanabilir KapatÄ±cÄ± 323 Fawn COL category VAL KapatÄ±cÄ±lar	0
COL name VAL L'Oreal Paris Rouge Signature Matte Likit Ruj 104 Rebel COL category VAL L"Oreal Paris ParlatÄ±cÄ± & DolgunlaÅŸtÄ±rÄ±cÄ±	COL name VAL L'oreal paris Likit Mat Ruj Rouge Signature 104 Rebel 3600523543649 COL category VAL nan	1
COL name VAL L'Oreal Paris Rouge Signature Matte Likit Ruj 113 Dont COL category VAL L"Oreal Paris ParlatÄ±cÄ± & DolgunlaÅŸtÄ±rÄ±cÄ±	COL name VAL L'OrÃ©al Paris Rouge Signature Likit Mat Ruj - 113 I don't COL category VAL Rujlar	1
COL name VAL Loreal Paris Loeral Infaillable Lipstick 2 Steps 801-TOUJOURS COL category VAL Rujlar	COL name VAL L'oreal paris L'orÃ©al Paris Infaillible 2-step 24 Saat KalÄ±cÄ± Likit Ruj & Balm - 801 Toujours Toffee COL category VAL Dudak MakyajÄ±	1
COL name VAL L'OrÃ©al Paris Color Riche Shine Ruj 470 Map to Nirvana - Mor COL category VAL Rujlar	COL name VAL L'oreal paris Color Riche Shine Addiction Lipstick 470 Map To Nirvana Ruj 3600523518753 COL category VAL Dudak MakyajÄ±	1
COL name VAL L'OrÃ©al Paris Brow Artist High Contour 105 Brunette - Kumral COL category VAL KaÅŸ MakyajÄ±	COL name VAL L'oreal paris KaÅŸ Kalemi - Brow Artist High Contour 108 Warm Brown 3600523601684 COL category VAL nan	1
COL name VAL L'oreal paris Lash Paradise Intense Black Ekstra Siyah Maskara 2'li Set ve Ayna COL category VAL Maskara	COL name VAL Loreal Paris L'orÃ©al Paris Lash Paradise Intense Black Ekstra Siyah Maskara 2'li Set 1 Paket (1 x 2 Adet COL category VAL Maskara	0
COL name VAL L'oreal paris Infaillible 24h Matte Cover YÃ¼ksek KapatÄ±cÄ± FondÃ¶ten 155 Natural Rose COL category VAL FondÃ¶ten	COL name VAL L'OrÃ©al Paris Infaillible 24H Matte Cover YÃ¼ksek KapatÄ±cÄ± FondÃ¶ten - 155 Natural Rose COL category VAL Likit	1
COL name VAL L'OrÃ©al Paris Brow Artist High Contour 105 Brunette - Kumral COL category VAL KaÅŸ MakyajÄ±	COL name VAL L'oreal paris KaÅŸ Kalemi - Brow Artist High Contour 108 Warm Brown 3600523601684 COL category VAL KaÅŸ Kalemi&KaÅŸ FarÄ±	1
COL name VAL L'OrÃ©al Paris Les Macarons Likit Mat Ruj 824 Guava Gush COL category VAL Rujlar	COL name VAL L'oreal paris Likit Mat Ruj - Les Macarons Ultra Matte Liquid Lipstick 824 Guava Gush COL category VAL Dudak MakyajÄ±	1
COL name VAL Loreal botanicals GÃ¶z FarÄ± Paleti - La Petite Palette Stylist 3600523556045 COL category VAL GÃ¶z FarÄ±	COL name VAL L'OrÃ©al Paris La Petite Far Paleti - Stylist COL category VAL GÃ¶z FarÄ±	1
COL name VAL L'OrÃ©al Paris Infaillible TÃ¼m YÃ¼ze Uygulanabilir KapatÄ±cÄ± 330 Pecan COL category VAL KapatÄ±cÄ±	COL name VAL L'oreal paris L'OrÃ©al Paris Infaillible 24H TÃ¼m YÃ¼ze Uygulanabilir KapatÄ±cÄ± - 330 Pecan COL category VAL Makyaj	0
COL name VAL L'oreal paris L'orÃ©al Paris Color Riche Plump & Shine Ruj COL category VAL Dudak MakyajÄ±	COL name VAL L'OrÃ©al Paris Color Riche Plump & Shine Ruj 106 Pitaya Plump COL category VAL Rujlar	0
COL name VAL L'oreal paris 24 Saat KalÄ±cÄ± Ruj - Infaillible Rouge 217 Eternal Vamp 3600523600595 COL category VAL Dudak MakyajÄ±	COL name VAL L'OrÃ©al Paris Infaillible 24H Ruj 217 ETERNAL VAMP- MÃ¼rdÃ¼m COL category VAL Dudaklar	1
COL name VAL L'OrÃ©al Paris Superliner Ultra Precision Siyah Eyeliner COL category VAL Eyeliner	COL name VAL L'oreal paris Siyah Eyeliner - Ultra Precision Superliner 01 3054080005773 COL category VAL Eyeliner	1
COL name VAL L'oreal paris Bambi Eye Ceylan GÃ¶z Etkili Maskara  Siyah COL category VAL Maskara	COL name VAL L'orÃ©al Paris Bambi Eye Oversized Ceylan GÃ¶z Etkili Maskara - Siyah COL category VAL Maskara	0
COL name VAL L'Oreal Paris Color Riche Matte Addiction Ruj 655 Copper Clutch COL category VAL L"Oreal Paris Ruj	COL name VAL L'oreal paris Mat Ruj - Color Riche Matte Addiction 655 Copper Clutch 3600523584741 COL category VAL Dudak MakyajÄ±	1
COL name VAL L'oreal paris L'OrÃ©al Paris Infaillible 32H Fresh Wear C Vitaminli FondÃ¶ten - 140 Golden Beige COL category VAL FondÃ¶ten	COL name VAL L'OrÃ©al Paris Infaillible 24H FondÃ¶ten 140 GOLDEN BEIGE COL category VAL Krem	1
COL name VAL L'oreal paris Volume Million Lashes Balm Noir Maskara COL category VAL Maskara	COL name VAL Loreal Paris L'orÃ©al Paris Volume Million Lashes Maskara COL category VAL Maskara	0
COL name VAL L'OrÃ©al Paris True Match Pudra W1 GOLDEN IVORY COL category VAL Pudra	COL name VAL L'oreal paris Pudra - True Match Powder 1.D 1.W Golden Ivory 3600520772011 COL category VAL Makyaj	1
COL name VAL L'OrÃ©al Paris Unlimited Siyah Maskara COL category VAL Maskara	COL name VAL L'oreal paris Unlimited Maskara Siyah COL category VAL Maskara	1
COL name VAL Loreal Paris L'orÃ©al Paris Telescopic Maskara - Siyah 1 Paket COL category VAL Maskara	COL name VAL L'oreal paris Telescopic Maskara - Siyah COL category VAL Maskara	0
COL name VAL L'oreal paris Infaillible Lip Paint Likit Ruj Matte 207 Wuthering Purple COL category VAL Dudak MakyajÄ±	COL name VAL Loreal Paris Infaillible Lip Paint Likit Ruj Matte 207 Wuthering Purple COL category VAL Rujlar	0
COL name VAL Loreal Paris L'oreal Paris Bambi Eye Ceylan GÃ¶z Etkili Maskara Eks. Siyah Maskara COL category VAL Maskara	COL name VAL L'oreal paris Siyah Bambi Eye Oversized Ceylan GÃ¶z Etkili Maskara COL category VAL Maskara	0
COL name VAL L'oreal paris Mat Ruj - Color Riche Matte Addiction 652 Stone 3600523584710 COL category VAL nan	COL name VAL L'OrÃ©al Paris Color Riche Matte Addiction Ruj 652 Stone - Nude COL category VAL Rujlar	1
COL name VAL L'oreal paris Infaillible 24h Matte Cover YÃ¼ksek KapatÄ±cÄ± FondÃ¶ten 155 Natural Rose COL category VAL FondÃ¶ten	COL name VAL L'OrÃ©al Paris Infaillible 24H Matte Cover YÃ¼ksek KapatÄ±cÄ± FondÃ¶ten - 145 Rose Beige COL category VAL Likit	0
COL name VAL L'oreal paris True Match Foundation 6n Honey 30 ml FondÃ¶ten - 3600522862437 COL category VAL nan	COL name VAL L'OrÃ©al Paris True Match BakÄ±m Yapan FondÃ¶ten 6N HONEY COL category VAL Likit	1
COL name VAL L'oreal paris Color Riche Intense Volume Matte Ruj - 603 Wood Nonchalant COL category VAL Dudak MakyajÄ±	COL name VAL L'orÃ©al Paris Color Riche Intense Volume Matte Ruj - 603 Wood Nonchalant COL category VAL Rujlar	1
COL name VAL Loreal Paris Marka: L'oreal Paris Pembe Color Riche Saten BitiÅŸli Violet Saturne Ruj 214 Kategori: Ruj COL category VAL Rujlar	COL name VAL L'oreal paris Pembe Color Riche Saten BitiÅŸli Violet Saturne Ruj 214 COL category VAL Dudak MakyajÄ±	0
COL name VAL L'oreal paris Infaillible Lip Pencil 101 Gone With The Nude Dudak Kalemi - 3600523485642 COL category VAL Dudak MakyajÄ±	COL name VAL L'OrÃ©al Paris Infaillible Dudak Kalemi 101 Gone With The Nude- Nude COL category VAL Dudak Kalemleri	1
COL name VAL L'oreal paris Lash Paradise Intense Black Ekstra Siyah Maskara COL category VAL Maskara	COL name VAL Loreal Paris Paradise Intense Black Ekstra Siyah Maskara x 2 COL category VAL Maskara	0
COL name VAL L'oreal Paris Color Riche Free The Nudes Ruj - No Pressure COL category VAL Rujlar	COL name VAL L'oreal paris Ruj - Color Riche Free The Nudes 10 Pressure 3600523747238 COL category VAL nan	1
COL name VAL L'oreal paris L'orÃ©al Paris Color Riche Plump & Shine Ruj COL category VAL Dudak MakyajÄ±	COL name VAL L'OrÃ©al Paris Color Riche Plump & Shine Ruj 109 Blue Mint Plump COL category VAL Rujlar	0
COL name VAL L'OrÃ©al Paris Color Riche Plump & Shine Ruj 108 Wild Fig Plump COL category VAL Rujlar	COL name VAL L'oreal paris L'orÃ©al Paris Color Riche Plump & Shine Ruj COL category VAL Dudak MakyajÄ±	1
COL name VAL L'oreal paris Ruj - Color Riche Shine Naked Tans 659 Blow Your Glow - Nude 3600523597789 COL category VAL nan	COL name VAL L'OrÃ©al Paris Color Riche Shine Naked Tans Ruj 658 Topless - Nude COL category VAL Dudaklar	1
COL name VAL L'OrÃ©al Paris True Match BakÄ±m Yapan FondÃ¶ten 9N Truffe COL category VAL Likit	COL name VAL L'oreal paris L'orÃ©al Paris True Match BakÄ±m Yapan FondÃ¶ten 5n Sand COL category VAL FondÃ¶ten	0
COL name VAL L'orÃ©al Paris Infaillible Matte Lip Crayon Kalem Mat Ruj - 110 Caramel Rebel 1 Paket (1 X 1 COL category VAL Rujlar	COL name VAL L'oreal paris Infaillible Matte Lip Crayon Kalem Mat Ruj - 110 Caramel Rebel COL category VAL Dudak MakyajÄ±	0
COL name VAL L'OrÃ©al Paris True Match BakÄ±m Yapan FondÃ¶ten 1D Golden Ivory COL category VAL Likit	COL name VAL L'OrÃ©al Paris True Match BakÄ±m Yapan FondÃ¶ten 1D GOLDEN IVORY COL category VAL Loreal Paris FondÃ¶ten	1
COL name VAL L'oreal paris Pudra - True Match Powder 1.D 1.W Golden Ivory 3600520772011 COL category VAL Makyaj	COL name VAL L'OrÃ©al Paris True Match Pudra W1 GOLDEN IVORY COL category VAL Pudra	1
COL name VAL L'oreal paris Unlimited Siyah Maskara COL category VAL Maskara	COL name VAL Loreal Paris Unlimited Siyah Maskara 2'li Set COL category VAL Maskara	0
COL name VAL L'OrÃ©al Paris Infaillible 24H FondÃ¶ten 230 RADIANT HONEY COL category VAL Likit	COL name VAL L'oreal paris Uzun SÃ¼re KalÄ±cÄ± FondÃ¶ten Infallible 24h Foundation 230 Golden 30 ml 3600522690375 COL category VAL nan	1
COL name VAL L'oreal paris FondÃ¶ten True Match Foundation 4d Golden Natural 30 ml 3600522862550 COL category VAL nan	COL name VAL L'OrÃ©al Paris True Match BakÄ±m Yapan FondÃ¶ten 4D GOLDEN NATURAL COL category VAL Likit	1
COL name VAL L'oreal paris Brow Artist Skinny Definer KaÅŸ Kalemi 105 Brunette 3600523796854 COL category VAL KaÅŸ Kalemi&KaÅŸ FarÄ±	COL name VAL L'OrÃ©al Paris Brow Artist Skinny Definer KaÅŸ Kalemi - 105 Brunette COL category VAL KaÅŸ MakyajÄ±	1
COL name VAL L'oreal paris Pembe Color Riche Saten BitiÅŸli Violet Saturne Ruj 214 COL category VAL Dudak MakyajÄ±	COL name VAL L'orÃ©al Paris Color Riche Saten BitiÅŸli Ruj 214 Violet Saturne - Pembe 1 Paket (1 X 9.1 G) COL category VAL Rujlar	0
COL name VAL L'oreal paris Ruj - Color Riche Lipstick 134 Pink Panac 3600522851042 COL category VAL nan	COL name VAL L'Oreal Paris Ruj No: 134 COL category VAL L"Oreal Paris Ruj	1
COL name VAL L'OrÃ©al Paris Brow Artist Xpert No 108 Warm Brunette COL category VAL KaÅŸ MakyajÄ±	COL name VAL L'oreal paris KaÅŸ Kalemi - Brow Artist Xpert 108 Warm Brune 3600523352869 COL category VAL nan	1
COL name VAL L'oreal paris Pudra - Infallible Powder 245 Warm Sand 3600522536208 COL category VAL nan	COL name VAL L'OrÃ©al Paris Colorista Washout Redhair COL category VAL Pudra	1
COL name VAL Loreal Paris L'orÃ©al Paris Color Riche Free The Nudes Ruj - No Cliche COL category VAL Makyaj ÃœrÃ¼nleri	COL name VAL L'oreal paris Ruj - Color Riche Free The Nudes 08 No Lies COL category VAL Dudak MakyajÄ±	0
COL name VAL L'oreal paris False Lash Telescopic Fiber Siyah Maskara -3600522097303 COL category VAL nan	COL name VAL L'OrÃ©al Paris False Lash Telescopic Fiber Maskara - Siyah COL category VAL Maskara	1
COL name VAL L'oreal paris Bambi Eye Extra Black Ceylan GÃ¶z Etkili Maskara Ekstra Siyah 30178564 COL category VAL Maskara	COL name VAL Loreal Paris L'orÃ©al Paris Bambi Eye Extra Black Ceylan GÃ¶z Etkili Maskara - Ekstra Siyah COL category VAL Maskara	0
COL name VAL L'OrÃ©al Paris Infaillible 24H Matte Cover YÃ¼ksek KapatÄ±cÄ± FondÃ¶ten - 145 Rose Beige COL category VAL Likit	COL name VAL L'oreal paris Infaillible 24h Matte Cover YÃ¼ksek KapatÄ±cÄ± FondÃ¶ten 115 Golden Beige COL category VAL FondÃ¶ten	0
COL name VAL L'oreal paris Rouge Signature Likit Mat Ruj - 115 I Am Worth It COL category VAL Dudak MakyajÄ±	COL name VAL L'OrÃ©al Paris Rouge Signature Likit Mat Ruj - 115 I am worth it COL category VAL Rujlar	1
COL name VAL L'oreal paris Rouge Signature Parisian Sunset Likit Mat Ruj 132radiate COL category VAL Dudak MakyajÄ±	COL name VAL L'OrÃ©al Paris Rouge Signature Parisian Sunset Likit Mat Ruj - 132 I Radiate COL category VAL Rujlar	0
COL name VAL L'oreal paris AllÄ±k - True Match Le Blush No: 105 Rose Pastel 3600522774600 COL category VAL nan	COL name VAL L'OrÃ©al Paris True Match AllÄ±k 105 ROSE PASTEL COL category VAL AllÄ±klar	1
COL name VAL Lâ€™oreal Paris Color Riche Ruj No:125 Maison Marais 3600523802005 COL category VAL Loreal Paris Ruj	COL name VAL L'OrÃ©al Paris Color Riche Saten BitiÅŸliRuj 125 Maison Marais - KÄ±rmÄ±zÄ± COL category VAL Rujlar	1
COL name VAL L'orÃ©al Paris True Match BakÄ±m Yapan FondÃ¶ten 1r Rose Ivory COL category VAL Likit	COL name VAL L'oreal paris True Match BakÄ±m Yapan FondÃ¶ten 1R ROSE IVORY COL category VAL FondÃ¶ten	0
COL name VAL L'oreal paris Siyah Maskara - False Lash Architect 4D Mascara Black 3600521877104 COL category VAL Maskara	COL name VAL L'OrÃ©al Paris Lash Architect 4D Siyah Maskara COL category VAL Maskara	1
COL name VAL L'OrÃ©al Paris Color Riche Free The Nudes Ruj - No Doubts COL category VAL Rujlar	COL name VAL L'Oreal Paris Color Richa Ultra Matte Mat Ruj No: 6 Hesitation COL category VAL L"Oreal Paris Ruj	1
COL name VAL Loreal Paris Ultra Matte Liquid Lipstick Les Chocolats 856 Yum 7.5ml COL category VAL Rujlar	COL name VAL L'oreal paris Ultra Matte Liquid Lipstick Les Chocolats 856 Yum 7.5ml COL category VAL Dudak MakyajÄ±	0
COL name VAL L'orÃ©al Paris Brilliant Signature Plump In Gloss Ruj 402 I Soar COL category VAL Rujlar	COL name VAL L'oreal paris L'orÃ©al Paris Brilliant Signature Plump In Gloss Ruj 404 I Insert COL category VAL Dudak MakyajÄ±	0
COL name VAL L'OrÃ©al Paris True Match KapatÄ±cÄ± 3N Creamy Beige COL category VAL KapatÄ±cÄ±lar	COL name VAL L'oreal paris True Match KapatÄ±cÄ± 3n Creamy Beige COL category VAL Makyaj	1
COL name VAL L'oreal paris L'orÃ©al Paris Brow Artist Plump & Set Renkli KaÅŸ Sabitleyici Maskara - 105 Brunette COL category VAL KaÅŸ Sabitleyici	COL name VAL Loreal Paris KaÅŸ MaskarasÄ± Brow AsÄ±st Plumo & Set 105 Brunette COL category VAL KaÅŸ MakyajÄ±	1
COL name VAL Loreal Paris L'oreal Paris Mega Air Volume Siyah Maskara 58 ml Maskara COL category VAL Maskara	COL name VAL L'oreal paris Air Volume Mega Maskara COL category VAL Maskara	0
COL name VAL L'oreal paris Bambi Eye Ceylan GÃ¶z Etkili Siyah Maskara COL category VAL Maskara	COL name VAL Loreal Paris L'oreal Paris Bambi Eye Ceylan GÃ¶z Etkili Maskara Eks. Siyah Maskara COL category VAL Maskara	0
COL name VAL Loreal botanicals Loreal Paris Superliner Silkissime 03 Moonlight Blue COL category VAL Dudak MakyajÄ±	COL name VAL Loreal Paris Superliner Silkissime 03 Moonlight Blue COL category VAL Eyeliner	0
COL name VAL Loreal Paris Loreal Color Riche Lipstick 163 Orange Magique COL category VAL Rujlar	COL name VAL L'oreal paris Loreal Color Riche Lipstick 163 Orange Magique COL category VAL Dudak MakyajÄ±	0
COL name VAL L'oreal paris ParlatÄ±cÄ± Ruj - Rouge Signature Lip Topper 210 White Gold 3600523690688 COL category VAL Dudak MakyajÄ±	COL name VAL L'OrÃ©al Paris Rouge Signature Lip Topper Dudak ParlatÄ±cÄ± Ruj - 210 White Gold COL category VAL Rujlar	1
COL name VAL L'oreal paris Bambi Eye False Lash Waterproof 6.7ml COL category VAL Maskara	COL name VAL Loreal Paris Bambi Eye False Lash Waterproof 6.7ml COL category VAL Maskara	0
COL name VAL L'oreal paris Ruj - Color Riche Free The Nudes 04 No Cage COL category VAL Dudak MakyajÄ±	COL name VAL L'oreal Paris Color Riche Free The Nudes Ruj - No Pressure COL category VAL Rujlar	0
COL name VAL L'oreal paris Koyu Kahverengi KaÅŸ Kalemi - Brow Artist Shaper 04 Dark Brunette 3600522426820 COL category VAL nan	COL name VAL L'OrÃ©al Paris Brow Artist Shaper KaÅŸ Kalemi 04 Dark Brunette COL category VAL KaÅŸ MakyajÄ±	1
COL name VAL L'orÃ©al Paris Micellar Kusursuz Makyaj Temizleme Suyu Hassas 400ML COL category VAL Makyaj Temizleme ÃœrÃ¼nleri	COL name VAL L'oreal paris L'orÃ©al Paris Kusursuz Makyaj Temizleme Suyu Hassas 400 ml COL category VAL nan	0
COL name VAL L'oreal paris Infaillible 24H Matte Cover YÃ¼ksek KapatÄ±cÄ± FondÃ¶ten 200 Golden Sand 3600523784455 COL category VAL FondÃ¶ten	COL name VAL L'OrÃ©al Paris Infaillible 24H Matte Cover YÃ¼ksek KapatÄ±cÄ± FondÃ¶ten - 200 Golden Sand COL category VAL Likit	1
COL name VAL L'oreal paris L'orÃ©al Paris True Match BakÄ±m Yapan FondÃ¶ten 4n BeÄ±ge COL category VAL FondÃ¶ten	COL name VAL L'OrÃ©al Paris True Match BakÄ±m Yapan FondÃ¶ten 5N SAND COL category VAL Krem	0
COL name VAL Loreal Paris L'oreal Paris False Lash Telescopic Fiber Maskara - Siyah Maskara COL category VAL Maskara	COL name VAL L'oreal paris Paris False Lash Telescopic Fiber Maskara COL category VAL Maskara	0
COL name VAL L'oreal paris Likit Mat Ruj - Rouge Signature COL category VAL Dudak MakyajÄ±	COL name VAL L'OrÃ©al Paris Rouge Signature Likit Mat Ruj - 105 I Rule COL category VAL Rujlar	0
COL name VAL L'oreal paris Volume Million Lashes KadÄ±nlar GÃ¼nÃ¼ Ã–zel TasarÄ±m 3600523822744 COL category VAL nan	COL name VAL Loreal Paris Lâ€™orÃ©al Paris Maskara Volume Million Lashes KadÄ±nlar GÃ¼nÃ¼ Ã–zel TasarÄ±m COL category VAL Maskara	1
COL name VAL L'oreal paris L'orÃ©al Paris Color Riche Plump & Shine Ruj COL category VAL Dudak MakyajÄ±	COL name VAL L'OrÃ©al Paris Color Riche Plump & Shine Ruj 105 Mulberry Plump COL category VAL Rujlar	0
COL name VAL L'OrÃ©al Paris Color Riche Plump & Shine Ruj 109 Blue Mint Plump COL category VAL Rujlar	COL name VAL L'oreal paris L'orÃ©al Paris Color Riche Plump & Shine Ruj COL category VAL Dudak MakyajÄ±	0
COL name VAL L'Oreal Paris Les Macarons Ultra Matte Likit Ruj 828 Framboise COL category VAL L"Oreal Paris ParlatÄ±cÄ± & DolgunlaÅŸtÄ±rÄ±cÄ±	COL name VAL L'OrÃ©al Paris Les Macarons Likit Mat Ruj 828 Framboise Frenzy COL category VAL Rujlar	1
COL name VAL L'oreal paris Emotions Of Nu AllÄ±k & Far Paleti EmotÄ±ons Nude COL category VAL GÃ¶z FarÄ±	COL name VAL Loreal Paris Emotions Of Nu AllÄ±k &amp; Far Paleti COL category VAL GÃ¶z FarÄ±	0
COL name VAL Loreal Paris True Match GÃ¶z Kremi IÃ§eren KapatÄ±cÄ± 1-2.d Ivory Beige COL category VAL KapatÄ±cÄ±	COL name VAL L'oreal paris True Match GÃ¶z Kremi Ä°Ã§eren KapatÄ±cÄ±  2'si 1 Arada  1-2D Ivory BeÄ±ge COL category VAL Makyaj	1
COL name VAL L'OrÃ©al Paris Infaillible 24H FondÃ¶ten 230 RADIANT HONEY COL category VAL Likit	COL name VAL L'oreal paris Uzun SÃ¼re KalÄ±cÄ± FondÃ¶ten - Infallible 24H Foundation 230 Golden 30 ml 3600522690375 COL category VAL FondÃ¶ten	1
COL name VAL L'oreal paris Paradise Makyaj Seti 8690595803685 COL category VAL nan	COL name VAL Loreal Paris Paradise Makyaj Seti COL category VAL Makyaj Setleri	1
COL name VAL L'OrÃ©al Paris Bonjour Nudista AydÄ±nlÄ±k Veren Renkli Nemlendirici 04 Medium Dark - Koyu Ton COL category VAL Krem	COL name VAL L'oreal paris Bb Krem - Bonjour Nudista Bb Cream 04 Medium Dark 3600523560615 COL category VAL Makyaj	1
COL name VAL L'Oreal Paris Rouge Signature Matte Likit Ruj 114 Represent COL category VAL L"Oreal Paris ParlatÄ±cÄ± & DolgunlaÅŸtÄ±rÄ±cÄ±	COL name VAL L'OrÃ©al Paris Rouge Signature Likit Mat Ruj - 114 I represent COL category VAL Rujlar	1
COL name VAL L'OrÃ©al Paris Color Riche Plump & Shine Ruj 107 Coconut Plump COL category VAL Rujlar	COL name VAL L'oreal paris Color Riche Plump & Shine Ruj COL category VAL Dudak MakyajÄ±	1
COL name VAL L'oreal paris FondÃ¶ten - True Match Foundation 6n Honey 30 ml 3600522862437 COL category VAL FondÃ¶ten	COL name VAL L'OrÃ©al Paris True Match BakÄ±m Yapan FondÃ¶ten 6N HONEY COL category VAL Likit	1
COL name VAL L'OrÃ©al Paris Infaillible Eye Paint GÃ¶z FarÄ± 201 Goldeneye COL category VAL GÃ¶z FarÄ±	COL name VAL L'oreal paris GÃ¶z FarÄ± - Infallible Eyeshadow Paint 201 Golden Eye 3600523240852 COL category VAL nan	1
COL name VAL L'oreal paris Kuru ve Hassas Ciltler iÃ§in ÃœÃ§ Etkili Makyaj Temizleme Suyu 200 ml 3600522365846 COL category VAL Makyaj Temizleyici	COL name VAL Loreal Paris ÃœÃ§ Etkili Makyaj Temizleme Suyu Kuru - Hassas Ciltler 200 ml COL category VAL Makyaj Temizleme ÃœrÃ¼nleri	0
COL name VAL Loreal Paris Loreal True Match Nude Serum FondÃ¶ten Light Medium 360 FondÃ¶ten FÄ±rÃ§asÄ± COL category VAL Likit	COL name VAL L'oreal paris L'orÃ©al Paris True Match Nude FondÃ¶ten Serum 3-4 Light Medium COL category VAL FondÃ¶ten	0
COL name VAL L'OrÃ©al Paris Infaillible Dudak Kalemi 101 Gone With The Nude- Nude COL category VAL Dudak Kalemleri	COL name VAL L'oreal paris Infaillible Lip Pencil 101 Gone With The Nude Dudak Kalemi - 3600523485642 COL category VAL Dudak MakyajÄ±	1
COL name VAL L'OrÃ©al Paris Glow Mon Amour Likit AydÄ±nlatÄ±cÄ± 03 Bronze In Love COL category VAL AydÄ±nlatÄ±cÄ±lar	COL name VAL L'oreal paris Likit AydÄ±nlatÄ±cÄ± - Glow Mon Amour Droplet Highlight 03 Bronze In Love 3600523706747 COL category VAL nan	1
COL name VAL Loreal Concealer True MagÄ±c 5n COL category VAL KapatÄ±cÄ±	COL name VAL L'oreal paris True Match MagÄ±c 5n KapatÄ±cÄ± COL category VAL Makyaj	1
COL name VAL L'oreal Paris Lash Paradise Intense Black Ekstra Siyah Maskara COL category VAL Maskara	COL name VAL L'oreal paris Lash Paradise Intense Black Ekstra Siyah Maskara 3600523897308 COL category VAL Maskara	1
COL name VAL L'Oreal Paris Kalem Ruj No: 915 COL category VAL L"Oreal Paris Ruj	COL name VAL L'OrÃ©al Paris Glam Shine Balmy Gloss- 915 COL category VAL Rujlar	1
COL name VAL L'oreal paris Telescopic Carbon Extra Black Maskara - Siyah COL category VAL Maskara	COL name VAL Loreal Paris L'orÃ©al Paris Telescopic Carbon Black Maskara, Siyah, 8 ml COL category VAL Maskara	0
COL name VAL Loreal Paris Emotions Of Nu AllÄ±k &amp; Far Paleti COL category VAL GÃ¶z FarÄ±	COL name VAL L'oreal paris Emotions Of Nu AllÄ±k & Far Paleti EmotÄ±ons Nude COL category VAL GÃ¶z FarÄ±	0
COL name VAL L'OrÃ©al Paris Mega Volume Collagene 24H Siyah Maskara COL category VAL Maskara	COL name VAL L'oreal paris Mega Volume Collagene 24H Siyah Maskara COL category VAL Maskara	0
COL name VAL L'oreal paris Dudak Kalemi - Infaillible Lip Pencil 101 Gone With The Nude 3600523485642 COL category VAL Makyaj	COL name VAL L'OrÃ©al Paris Infaillible Dudak Kalemi 101 Gone With The Nude- Nude COL category VAL Dudak Kalemleri	1
COL name VAL L'OrÃ©al Paris Paradise Suya DayanÄ±klÄ± Siyah Maskara COL category VAL Maskara	COL name VAL L'oreal paris L'orÃ©al Paris Paradise Suya DayanÄ±klÄ± Siyah Maskara - Waterproof COL category VAL Maskara	0
COL name VAL L'OrÃ©al Paris Les Macarons Likit Mat Ruj 830 Blackcurrant Crush COL category VAL Rujlar	COL name VAL L'oreal paris Likit Mat Ruj - Les Macarons Ultra Matte Liquid Lipstick 830 Blackcurrant Crush 3600523729074 COL category VAL Dudak MakyajÄ±	1
COL name VAL L'oreal paris Likit Mat Ruj - Infaillible Lip Paint Matte 201 Hollywood Beige 3600523348084 COL category VAL Dudak MakyajÄ±	COL name VAL L'OrÃ©al Paris Infaillible Lip Paint Likit Ruj Matte 201 Hollywood Beige- Nude COL category VAL Rujlar	1
COL name VAL L'Oreal Paris Ruj No: 134 COL category VAL L"Oreal Paris Ruj	COL name VAL L'OrÃ©al Paris Color Riche Ruj 134 PINK PANAC COL category VAL Rujlar	1
COL name VAL L'OrÃ©al Paris Les Chocolats Likit Mat Ruj 858 Oh My Choc! COL category VAL Rujlar	COL name VAL L'oreal paris Likit Mat Ruj - Les Chocolats Ultra Matte Liquid Lipstick 858 Oh My Choc! 3600523643837 COL category VAL nan	1
COL name VAL L'oreal paris 2 Li Set Unlimited Siyah Maskara & Infaillible TÃ¼m YÃ¼ze Uygulanabilir KapatÄ±cÄ± 322 Ivory COL category VAL Makyaj Seti	COL name VAL Loreal Paris Paradise Siyah Maskara 2'li + Infaillible TÃ¼m YÃ¼ze Uygulanabilir KapatÄ±cÄ± 322 Ivory + Makyaj FÄ±rÃ§asÄ± COL category VAL Maskara	0
COL name VAL L'OrÃ©al Paris Brow Artist High Contour 107 Cool Brunette - Koyu Kumral COL category VAL KaÅŸ MakyajÄ±	COL name VAL L'oreal paris KaÅŸ Kalemi - Brow Artist High Contour 107 Cool Brown 3600523601677 COL category VAL nan	1
COL name VAL L'oreal paris Loreal Color Riche Lipstick 214 Violet Saturn COL category VAL Dudak MakyajÄ±	COL name VAL Loreal Paris Loreal Color Riche Lipstick 214 Violet Saturn COL category VAL Rujlar	0
COL name VAL Loreal Paris Lâ€™orÃ©al Paris Uzun SÃ¼re KalÄ±cÄ± KaÅŸ Jeli Unbelieva Brow - 105 Brunette COL category VAL KaÅŸ MakyajÄ±	COL name VAL L'oreal paris Unbelieva Brow Uzun SÃ¼re KalÄ±cÄ± KaÅŸ Jeli - 109 Ebony COL category VAL KaÅŸ Kalemi&KaÅŸ FarÄ±	0
COL name VAL L'oreal paris Paris Waterproof Crayon Eyeliner 07 Silver COL category VAL Dudak MakyajÄ±	COL name VAL L'OrÃ©al Paris Infallible Waterproof Gel Crayon Eyeliner 07 Flash Silver COL category VAL Eyeliner	1
COL name VAL L'OrÃ©al Paris Infaillible 24H FondÃ¶ten 125 NATURAL ROSE COL category VAL Likit	COL name VAL L'oreal paris L'OrÃ©al Paris Infaillible 32H Fresh Wear C Vitaminli FondÃ¶ten - 125 Natural Beige COL category VAL FondÃ¶ten	1
COL name VAL L'orÃ©al Paris True Match BakÄ±m Yapan FondÃ¶ten 1r Rose Ivory, 30 ml COL category VAL Krem	COL name VAL L'oreal paris True Match BakÄ±m Yapan FondÃ¶ten 1n Ivory COL category VAL FondÃ¶ten	0
COL name VAL L'Oreal Paris 24 Saat KalÄ±cÄ± Kalem No 300 COL category VAL L"Oreal Paris GÃ¶z Kalemi	COL name VAL L'OrÃ©al Paris Infaillible 24H GÃ¶z Kalemi 300 CHOCOLATE ADDICTION COL category VAL GÃ¶z Kalemi	1
COL name VAL L'OrÃ©al Paris Infaillible 24H FondÃ¶ten 140 GOLDEN BEIGE COL category VAL Krem	COL name VAL L'oreal paris Infaillible 24h Fresh Wear Pudra FondÃ¶ten 140 Golden Beige COL category VAL Makyaj	0
COL name VAL L'Oreal Paris True Match BakÄ±m Yapan FondÃ¶ten 1.5 LÄ±nen COL category VAL Loreal Paris FondÃ¶ten	COL name VAL L'oreal paris L'OrÃ©al Paris True Match BakÄ±m Yapan FondÃ¶ten 1.5 Linen COL category VAL nan	1
COL name VAL L'oreal paris KontÃ¼r Paleti - Infallible Sculpt Contouring Palette 01 Light 3600523174997 COL category VAL Makyaj	COL name VAL L'OrÃ©al Paris Infaillible Sculpt Palette KontÃ¼r Paleti 03 MEDIUM DARK COL category VAL Pudra	1
COL name VAL L'oreal paris Ruj - Color Riche Privee Nudes - Naomi's Pink 3600523046980 COL category VAL Dudak MakyajÄ±	COL name VAL L'OrÃ©al Paris Color Riche La Vie En Rose Ruj NAOMI'S PINK COL category VAL Rujlar	1
COL name VAL L'OrÃ©al Paris False Lash Telescopic Fiber Maskara - Siyah COL category VAL Maskara	COL name VAL L'oreal paris False Lash Telescopic Fiber Siyah Maskara -3600522097303 COL category VAL nan	1
COL name VAL L'oreal paris L'orÃ©al Paris True Match Nude FondÃ¶ten Serum 0.5-2 Very Light COL category VAL FondÃ¶ten	COL name VAL L'OrÃ©al Paris True Match Nude FondÃ¶ten Serum 2-3 Light COL category VAL Likit	0
COL name VAL L'oreal paris L'orÃ©al Paris Mega Volume Collagene 24h Siyah Maskara COL category VAL nan	COL name VAL L'OrÃ©al Paris Mega Volume Collagene 24H Siyah Maskara COL category VAL Maskara	1
COL name VAL L'OrÃ©al Paris Rouge Signature Empowereds Likit Mat Ruj - 138 Honored COL category VAL Rujlar	COL name VAL L'oreal paris Rouge Signature Empowereds Likit Mat Ruj 138 Honored 3600523799794 COL category VAL Dudak MakyajÄ±	1
COL name VAL L'OrÃ©al Paris Color Riche Shine Naked Tans Ruj 656 Beige In The City - Nude COL category VAL Rujlar	COL name VAL L'oreal paris Ruj - Color Riche Shine Naked Tans 659 Blow Your Glow - Nude 3600523597789 COL category VAL nan	1
COL name VAL L'oreal paris KapatÄ±cÄ± - True Match Concealer 2R/C Rose Vanilla 3600523500185 COL category VAL Makyaj	COL name VAL Loreal Paris KapatÄ±cÄ± COL category VAL KapatÄ±cÄ±lar	1
COL name VAL L'OrÃ©al Paris True Match BakÄ±m Yapan FondÃ¶ten 3D GOLDEN BEIGE COL category VAL Likit	COL name VAL L'oreal paris True Match BakÄ±m Yapan FondÃ¶ten 3D GOLDEN BEIGE COL category VAL FondÃ¶ten	1
COL name VAL L'OrÃ©al Paris Infaillible 24H Matte Cover YÃ¼ksek KapatÄ±cÄ± FondÃ¶ten - 155 Natural Rose COL category VAL Likit	COL name VAL L'oreal paris Infaillible 24h Matte Cover YÃ¼ksek KapatÄ±cÄ± FondÃ¶ten 155 Natural Rose 3600523784417 COL category VAL nan	1
COL name VAL L'OrÃ©al Paris True Match BakÄ±m Yapan FondÃ¶ten 4N BeÄ±ge COL category VAL Likit	COL name VAL L'oreal paris L'orÃ©al Paris True Match BakÄ±m Yapan FondÃ¶ten 4n BeÄ±ge COL category VAL nan	1
COL name VAL L'oreal paris GÃ¶z FarÄ± - Infallible Eyeshadow Paint 102 Irresistible 3600523240821 COL category VAL GÃ¶z FarÄ±	COL name VAL L'OrÃ©al Paris Infaillible Eye Paint GÃ¶z FarÄ± 102 Irresistible Rose COL category VAL GÃ¶z FarÄ±	1
COL name VAL L'oreal paris Infaillible 24h Matte Cover YÃ¼ksek KapatÄ±cÄ± FondÃ¶ten 115 Golden Beige COL category VAL nan	COL name VAL L'OrÃ©al Paris Infaillible 24H Matte Cover YÃ¼ksek KapatÄ±cÄ± FondÃ¶ten - 115 Golden Beige COL category VAL Likit	1
COL name VAL L'oreal paris Rouge Signature Parisian Sunset Likit Mat Ruj 128Decide 3600523739035 COL category VAL Dudak MakyajÄ±	COL name VAL L'OrÃ©al Paris Rouge Signature Parisian Sunset Likit Mat Ruj - 128 I Decide COL category VAL Rujlar	1
COL name VAL Loreal Paris L'oreal Paris Unbelieva Brow Uzun SÃ¼re KalÄ±cÄ± Åžeffaf KaÅŸ MaskarasÄ± COL category VAL KaÅŸ MakyajÄ±	COL name VAL L'oreal paris Unbelieva Brow Uzun SÃ¼re KalÄ±cÄ± Åžeffaf KaÅŸ MaskarasÄ± COL category VAL GÃ¶z MakyajÄ±	1
COL name VAL L'OrÃ©al Paris True Match BakÄ±m Yapan FondÃ¶ten 1D Golden Ivory COL category VAL Likit	COL name VAL L'oreal paris L'orÃ©al Paris True Match BakÄ±m Yapan FondÃ¶ten 7d Golden Amber COL category VAL FondÃ¶ten	0
COL name VAL L'OrÃ©al Paris Color Riche Shine Naked Tans Ruj 658 Topless - Nude COL category VAL Dudaklar	COL name VAL L'oreal paris L'orÃ©al Paris Color Riche Shine Naked Tans Ruj 656 Beige In The City - Nude COL category VAL nan	1
COL name VAL Loreal Paris Infallible Longwear Lip Liner 011 Violet Vava Voum COL category VAL Dudak Kalemleri	COL name VAL Loreal botanicals Loreal Paris Infallible Longwear Lip Liner 011 Violet Vava Voum COL category VAL Dudak MakyajÄ±	0
COL name VAL L'oreal paris Mavi Eyeliner - Infaillible Gel Crayon Eyeliner 10 Blue 3600523351589 COL category VAL GÃ¶z MakyajÄ±	COL name VAL L'Oreal Paris InfaÄ±llÄ±ble Gel Crayon 24h Eyeliner 10 Blue COL category VAL L"Oreal Paris Eyeliner	1
COL name VAL L'oreal paris Siyah Bambi Eye Oversized Ceylan GÃ¶z Etkili Maskara COL category VAL Maskara	COL name VAL L'oreal Paris Bambi Eye Extra Black Ceylan GÃ¶z Etkili Maskara Ekstra Siyah COL category VAL Maskara	0
COL name VAL Loreal Paris True Match GÃ¶z Kremi IÃ§eren KapatÄ±cÄ± Rose Porcelain COL category VAL KapatÄ±cÄ±	COL name VAL L'oreal paris True Match GÃ¶z Kremi Ä°Ã§eren KapatÄ±cÄ±  2'si 1 Arada  1-2R Rose Porcelain COL category VAL Makyaj	0
COL name VAL L'OrÃ©al Paris Glow Mon Amour Likit AydÄ±nlatÄ±cÄ± 02 Bellini COL category VAL AydÄ±nlatÄ±cÄ±lar	COL name VAL L'oreal paris L'OrÃ©al Paris Glow Mon Amour Likit AydÄ±nlatÄ±cÄ± 02 Loving Peach COL category VAL AydÄ±nlatÄ±cÄ±	1
COL name VAL L'oreal paris Loreal Telescopic Maskara GÃ¶z Makyaj Seti COL category VAL Maskara	COL name VAL Loreal Paris Telescopic Maskara GÃ¶z Makyaj Seti COL category VAL Maskara	0
COL name VAL L'OrÃ©al Paris True Match BakÄ±m Yapan FondÃ¶ten 6D Golden Honey COL category VAL Likit	COL name VAL L'oreal paris L'orÃ©al Paris True Match BakÄ±m Yapan FondÃ¶ten 5d Golden Sand COL category VAL FondÃ¶ten	0
COL name VAL L'OrÃ©al Paris Color Riche Plump & Shine Ruj 105 Mulberry Plump COL category VAL Rujlar	COL name VAL L'oreal paris Ruj - Color Riche Plump and Shine Lipstick 105 Mulberry 3600523687152 COL category VAL Dudak MakyajÄ±	1
COL name VAL L'oreal paris Karl Lagerfeld Collection Mat Eyeliner 12 Chic Rose Silver 30178540 COL category VAL GÃ¶z MakyajÄ±	COL name VAL Loreal Paris L'oreal Paris Karl Lagerfeld Collection Mat Eyeliner 12 Chic Rose Silver COL category VAL Eyeliner	1
COL name VAL L'OrÃ©al Paris Mascara Telescopic Black COL category VAL Maskara	COL name VAL L'oreal paris Loreal Paris L'orÃ©al Paris Mascara Telescopic Black. COL category VAL Maskara	0
COL name VAL L'OrÃ©al Paris Infaillible 24H Matte Cover YÃ¼ksek KapatÄ±cÄ± FondÃ¶ten - 155 Natural Rose COL category VAL Likit	COL name VAL L'oreal paris Infaillible 24H Matte Cover YÃ¼ksek KapatÄ±cÄ± FondÃ¶ten 155 Natural Rose 3600523784417 COL category VAL FondÃ¶ten	1
COL name VAL L'oreal paris Paris Infaillible 24h Concealer Pomade KapatÄ±cÄ± 02 Medium COL category VAL Makyaj	COL name VAL L'OrÃ©al Paris Infaillible 24H Concealer Pomade KapatÄ±cÄ± 02 Medium - Koyu Ton COL category VAL KapatÄ±cÄ±lar	1
COL name VAL L'OrÃ©al Paris True Match BakÄ±m Yapan FondÃ¶ten 5D GOLDEN SAND COL category VAL Loreal Paris FondÃ¶ten	COL name VAL L'oreal paris L'orÃ©al Paris True Match BakÄ±m Yapan FondÃ¶ten 5d Golden Sand COL category VAL FondÃ¶ten	1
COL name VAL L'OrÃ©al Paris Rouge Signature Likit Mat Ruj - 114 I represent COL category VAL Rujlar	COL name VAL L'Oreal Paris Rouge Signature Matte Likit Ruj 114 Represent COL category VAL L"Oreal Paris ParlatÄ±cÄ± & DolgunlaÅŸtÄ±rÄ±cÄ±	1
COL name VAL L'oreal paris Ruj - Color Riche Plump and Shine Lipstick 104 Guava Plump 3600523687145 COL category VAL Dudak MakyajÄ±	COL name VAL L'OrÃ©al Paris Color Riche Plump & Shine Ruj 104 Guava Plump COL category VAL Rujlar	1
COL name VAL L'OrÃ©al Paris Volumissime X5 Carbon Black Maskara - Siyah COL category VAL Maskara	COL name VAL L'oreal paris VolumÄ±ssÄ±me VolumÄ±nous X5 Extra Black Extra Volume Mascara COL category VAL Maskara	1
COL name VAL L'OrÃ©al Paris La Petite Far Paleti - Stylist COL category VAL GÃ¶z FarÄ±	COL name VAL L'oreal paris GÃ¶z FarÄ± Paleti - La Petite Palette Stylist 3600523556045 COL category VAL nan	1
COL name VAL L'OrÃ©al Paris Color Riche Matte Addiction Ruj 634 Greige Perfecto - Kahverengi COL category VAL Rujlar	COL name VAL L'oreal paris Mat Ruj - Color Riche Matte Addiction Lipstick 634 Geige Hype 3600523399802 COL category VAL Dudak MakyajÄ±	1
COL name VAL Loreal Paris Infallible Longwear Lip Liner 001 Highlight On Point COL category VAL Dudak Kalemleri	COL name VAL Loreal botanicals Loreal Paris Infallible Longwear Lip Liner 001 Highlight On Point COL category VAL Dudak MakyajÄ±	0
COL name VAL L'oreal paris TÃ¼m YÃ¼ze Uygulanabilir KapatÄ±cÄ± - Infaillible More Than Concealer 332 Amber 30173422 COL category VAL nan	COL name VAL L'OrÃ©al Paris Infaillible TÃ¼m YÃ¼ze Uygulanabilir KapatÄ±cÄ± 332 Amber COL category VAL Kozmetik KiÅŸisel BakÄ±m	1
COL name VAL L'OrÃ©al Paris Color Riche Ruj Exclusive Reds FREIDA'S PURE RED COL category VAL Rujlar	COL name VAL L'oreal paris Color Riche Exclusive Reds Freida's Red Ruj COL category VAL Dudak MakyajÄ±	0
COL name VAL L'OrÃ©al Paris Infaillible 24H Matte FondÃ¶ten 24 BEIGE DORE COL category VAL Likit	COL name VAL L'oreal paris Infaillible 24h Matte FondÃ¶ten 24 Beige Dore COL category VAL nan	1
COL name VAL L'oreal paris Mat Ruj - Color Riche Matte Addiction Lipstick 636 Mahogandy Studs 3600523399819 COL category VAL Dudak MakyajÄ±	COL name VAL L'OrÃ©al Paris Color Riche Matte Addiction Ruj 636 Mahogany Studs - Kahverengi COL category VAL Rujlar	1
COL name VAL L'OrÃ©al Paris Colorista Washout Redhair COL category VAL Pudra	COL name VAL L'oreal paris Pudra - Infallible Powder 245 Warm Sand 3600522536208 COL category VAL nan	1
COL name VAL L'oreal Paris True Match BakÄ±m Yapan FondÃ¶ten 5n Sand FondÃ¶ten COL category VAL Krem	COL name VAL L'oreal paris L'orÃ©al Paris True Match BakÄ±m Yapan FondÃ¶ten 4n BeÄ±ge COL category VAL nan	0
COL name VAL L'oreal paris FondÃ¶ten Infallible Golden Bej 3600520761923 COL category VAL nan	COL name VAL L'OrÃ©al Paris Infaillible 24H FondÃ¶ten 140 BEIGE DORE COL category VAL Likit	1
COL name VAL Loreal Paris L'orÃ©al Paris Color Riche Free The Nudes Ruj - No Dependency COL category VAL Rujlar	COL name VAL L'oreal paris Ruj - Color Riche Free The Nudes 11 No Dependency COL category VAL Dudak MakyajÄ±	1
COL name VAL Loreal Paris L'oreal Paris Bambi Eye Ceylan GÃ¶z Etkili Maskara Eks. Siyah Maskara COL category VAL Maskara	COL name VAL L'oreal paris L'OrÃ©al Paris Bambi Eye Ceylan GÃ¶z Etkili Maskara - Siyah COL category VAL Maskara	0
COL name VAL L'OrÃ©al Paris Lash Architect 4D Siyah Maskara COL category VAL Maskara	COL name VAL L'oreal paris Siyah Maskara - False Lash Architect 4D Mascara Black 3600521877104 COL category VAL Maskara	1
COL name VAL L'oreal paris Mat Ruj - Color Riche Matte Addiction Lipstick 346 Scarlet Silhouette 3600523399871 COL category VAL Dudak MakyajÄ±	COL name VAL L'OrÃ©al Paris Color Riche Matte Addiction Ruj 346 Scarlet Silhouette - KÄ±rmÄ±zÄ± COL category VAL Rujlar	1
COL name VAL L'oreal paris Ruj - Glam Shine Balmy Gloss 913 Dare The Dragon 3600522371137 COL category VAL nan	COL name VAL L'OrÃ©al Paris Glam Shine Balmy Gloss- 913 COL category VAL Rujlar	1
COL name VAL L'Oreal  Paris True Match BakÄ±m Yapan FondÃ¶ten 4N Beige COL category VAL L"Oreal Paris FondÃ¶ten	COL name VAL L'oreal paris True Match BakÄ±m Yapan FondÃ¶ten 4n BeÄ±ge COL category VAL FondÃ¶ten	1
COL name VAL L'oreal paris Ruj - Color Riche Free The Nudes 05 No Diktat COL category VAL Dudak MakyajÄ±	COL name VAL L'Oreal Paris Color Richa Ultra Matte Mat Ruj No Doubts COL category VAL L"Oreal Paris Ruj	1
COL name VAL L'OrÃ©al Paris Infaillible 24H FondÃ¶ten 200 GOLDEN SAND COL category VAL Krem	COL name VAL L'OrÃ©al Paris Infaillible 24H FondÃ¶ten - 200 Golden Sand COL category VAL Loreal Paris FondÃ¶ten	1
COL name VAL L'OrÃ©al Paris Infaillible TÃ¼m YÃ¼ze Uygulanabilir KapatÄ±cÄ± 323 Fawn COL category VAL KapatÄ±cÄ±lar	COL name VAL L'oreal paris Loreal Infaillible More Than Concealer KapatÄ±cÄ± 323 Fawn COL category VAL Makyaj	1
COL name VAL L'OrÃ©al Paris True Match Prestige Pudra- 3D Golden Beige COL category VAL Pudra	COL name VAL L'oreal paris Pudra - True Match Prestige Powder 3d Golden Beige 3600523499335 COL category VAL nan	1
COL name VAL L'oreal paris Infaillible 24h Fresh Wear 140 Beige Dore+kajal GÃ¶z Kalemi COL category VAL FondÃ¶ten	COL name VAL L'Oreal Paris Infaillible 24H Fresh Wear 140 Beige Dore + Kajal GÃ¶z Kalemi COL category VAL L"Oreal Paris FondÃ¶ten	1
COL name VAL L'OrÃ©al Paris True Match KapatÄ±cÄ± 2N Vanilla COL category VAL KapatÄ±cÄ±lar	COL name VAL L'oreal paris KapatÄ±cÄ± - True Match Concealer 2N Vanilla 3600523500192 COL category VAL Makyaj	1
COL name VAL L'OrÃ©al Paris Color Riche Free The Nudes Ruj - No Judgment COL category VAL Rujlar	COL name VAL L'oreal paris Ruj - Color Riche Free The Nudes 09 No Judgment COL category VAL Dudak MakyajÄ±	1
COL name VAL Loreal Paris L'oreal Paris Rouge Signature Likit Mat Ruj - 103 Enjoy Ruj COL category VAL Rujlar	COL name VAL L'oreal paris Loreal Rouge Signature Likit Mat Ruj 103 I Enjoy COL category VAL nan	0
COL name VAL L'OrÃ©al Paris Color Queen Tekli GÃ¶z FarÄ± 32 Commander COL category VAL GÃ¶z FarÄ±	COL name VAL L'oreal paris Tekli GÃ¶z FarÄ± - Color Queen Mono Eyeshadow 32 Commander 30173309 COL category VAL GÃ¶z FarÄ±	1
COL name VAL L'oreal paris Color Riche Plump & Shine Ruj 101 Nectarine Plump COL category VAL Dudak MakyajÄ±	COL name VAL L'OrÃ©al Paris Color Riche Plump & Shine Ruj 101 Nectarine Plump COL category VAL Rujlar	1
COL name VAL L'OrÃ©al Paris Infaillible Sculpt Palette KontÃ¼r Paleti 03 MEDIUM DARK COL category VAL Pudra	COL name VAL L'oreal paris KontÃ¼r Paleti - Infallible Sculpt Contouring Palette 03 Medium/Dark 3600523175093 COL category VAL Makyaj	1
COL name VAL L'Oreal Paris BB Krem - Bonjour Nudista BB Cream 04 Medium Dark COL category VAL Loreal Paris KapatÄ±cÄ±	COL name VAL L'OrÃ©al Paris Bonjour Nudista AydÄ±nlÄ±k Veren Renkli Nemlendirici 04 Medium Dark - Koyu Ton COL category VAL Krem	1
COL name VAL L'OrÃ©al Paris Les Chocolats Likit Mat Ruj 852 Box Of Chocolates COL category VAL Rujlar	COL name VAL L'Oreal Paris Les Chocolats Likit Mat Ruj 852 Box Of Chocolates COL category VAL L"Oreal Paris Ruj	1
COL name VAL L'oreal paris True Match BakÄ±m Yapan FondÃ¶ten 3N CREAMY BEIGE COL category VAL FondÃ¶ten	COL name VAL Loreal Paris True Match FondÃ¶ten 3n Creamy Beige COL category VAL Krem	0
COL name VAL L'oreal paris L'orÃ©al Paris Air Volume Mega Easy Waterproof Suya DayanÄ±klÄ± Maskara - Siyah COL category VAL Maskara	COL name VAL Loreal Paris L'orÃ©al Paris Air Volume Mega Easy Waterproof Suya DayanÄ±klÄ± Maskara - Siyah COL category VAL Maskara	0
COL name VAL Loreal Paris Bambi Eye False Lash Waterproof 6.7ml COL category VAL Maskara	COL name VAL L'oreal paris Bambi Eye False Lash Waterproof 6.7ml COL category VAL Maskara	0
COL name VAL L'oreal paris Likit Kompakt FondÃ¶ten - Nude Magique Liquid Cushion Foundation 04 Rose Vanilla 3600523161539 COL category VAL nan	COL name VAL L'OrÃ©al Paris Nude Magique Cushion FondÃ¶ten 04 ROSE VANILLA COL category VAL FondÃ¶ten	1
COL name VAL L'OrÃ©al Paris Brow Artist Genius Kit 01 Light to Medium - AÃ§Ä±ktan Ortaya COL category VAL KaÅŸ MakyajÄ±	COL name VAL L'oreal paris KaÅŸ Kiti AÃ§Ä±k - Brow Artist Genius Kit 01 Light to Medium Orta Ton 3600522832621 COL category VAL KaÅŸ Kalemi&KaÅŸ FarÄ±	1
COL name VAL L'oreal paris Pudra - True Match Prestige Powder 3d Golden Beige 3600523499335 COL category VAL nan	COL name VAL L'OrÃ©al Paris True Match Prestige Pudra- 3D Golden Beige COL category VAL Pudra	1
COL name VAL L'oreal paris Infaillible 24H TÃ¼m YÃ¼ze Uygulanabilir KapatÄ±cÄ± - 328 Lin COL category VAL Makyaj	COL name VAL L'OrÃ©al Paris Infaillible TÃ¼m YÃ¼ze Uygulanabilir KapatÄ±cÄ± 322 Ivory COL category VAL KapatÄ±cÄ±	0
COL name VAL L'OrÃ©al Paris Color Riche Free The Nudes Ruj - No Diktat COL category VAL Rujlar	COL name VAL L'oreal paris Ruj - Color Riche Free The Nudes 06 No Hesitation 3600523747153 COL category VAL Dudak MakyajÄ±	1
COL name VAL L'oreal paris True Match FondÃ¶ten 1r1c1k Ivory Rose COL category VAL FondÃ¶ten	COL name VAL Loreal Paris L'oreal Paris True Match FondÃ¶ten 1R1C1K Ivory Rose COL category VAL Krem	0
COL name VAL L'OrÃ©al Paris Extraordinaire 201 Rose Symphony COL category VAL Rujlar	COL name VAL L'oreal paris Likit Ruj - Color Riche L'Extraordinaire Lipstick 201 Rose Symphony 3600522458296 COL category VAL Ruj	1
COL name VAL L'oreal paris Loreal Infaillible More Than Concealer KapatÄ±cÄ± 322 Ivoire COL category VAL Makyaj	COL name VAL L'OrÃ©al Paris Infaillible TÃ¼m YÃ¼ze Uygulanabilir KapatÄ±cÄ± 322 Ivory COL category VAL KapatÄ±cÄ±	1
COL name VAL L'oreal paris KontÃ¼r Paleti - Infallible Sculpt Contouring Palette 01 Light 3600523174997 COL category VAL Makyaj	COL name VAL L'OrÃ©al Paris Infaillible Sculpt Palette KontÃ¼r Paleti 01 LIGHT MEDIUM COL category VAL Pudra	1
COL name VAL Loreal Paris Volume Million Lashes So Couture Noir Black Maskara 9.5 ml COL category VAL Maskara	COL name VAL L'oreal paris Volume Million Lashes So Couture Noir Black Maskara 9.5ml COL category VAL Maskara	0
COL name VAL Loreal True Match Powder N4 Beige + Pudra FÄ±rÃ§asÄ± Seti COL category VAL Pudra	COL name VAL Loreal True Match Powder N4 Beige Pudra FÄ±rÃ§asÄ± Seti COL category VAL Loreal Paris Pudra	1
COL name VAL L'oreal paris BB Krem - Bonjour Nudista BB Cream 04 Medium Dark 3600523560615 COL category VAL BB ve CC Krem	COL name VAL L'OrÃ©al Paris Bonjour Nudista AydÄ±nlÄ±k Veren Renkli Nemlendirici 04 Medium Dark - Koyu Ton COL category VAL Krem	1
COL name VAL L'oreal paris L'orÃ©al Paris Bambi Eye Oversized Ceylan GÃ¶z Etkili Maskara - Siyah COL category VAL Maskara	COL name VAL L'orÃ©al Paris Bambi Eye Oversized Ceylan GÃ¶z Etkili Maskara - Siyah COL category VAL Maskara	1
COL name VAL L'oreal paris True Match BakÄ±m Yapan FondÃ¶ten 1.5 LINEN COL category VAL FondÃ¶ten	COL name VAL L'OrÃ©al Paris True Match BakÄ±m Yapan FondÃ¶ten 1.5 LÄ±nen COL category VAL Likit	1
COL name VAL L'oreal paris Bambi Eye False Lash Ceylan GÃ¶z Etkili Ekstra Siyah Maskara COL category VAL Maskara	COL name VAL L'oreal Paris Bambi Eye Extra Black Ceylan GÃ¶z Etkili Maskara Ekstra Siyah COL category VAL Maskara	0
COL name VAL L'oreal paris Air Volume Mega Mascara 9.4ml COL category VAL Maskara	COL name VAL Loreal Paris Air Volume Mega Mascara 9.4ml COL category VAL Maskara	0
COL name VAL L'Oreal Paris True Match BakÄ±m Yapan FondÃ¶ten 1D Golden Ivory COL category VAL L"Oreal Paris FondÃ¶ten	COL name VAL L'Oreal Paris True Match BakÄ±m Yapan FondÃ¶ten 1d Golden Ivory COL category VAL FondÃ¶ten	1
COL name VAL L'OrÃ©al Paris True Match Nude FondÃ¶ten Serum 2-3 Light COL category VAL Likit	COL name VAL L'oreal paris L'orÃ©al Paris True Match Nude FondÃ¶ten Serum 3-4 Light Medium COL category VAL FondÃ¶ten	0
COL name VAL L'oreal paris Color Riche Les Nus Ruj 179 Nu Decadent COL category VAL Dudak MakyajÄ±	COL name VAL Loreal Paris L'oreal Paris Loreal Paris Color Riche Les Nus Ruj 179 Nu Decadent COL category VAL Rujlar	0
COL name VAL L'oreal paris Paradise Maskara Sevgililer Ve KadÄ±nlar GÃ¼nÃ¼ Ã–zel 3600523822690 COL category VAL nan	COL name VAL L'OrÃ©al Paris Paradise Maskara Sevgililer ve KadÄ±nlar GÃ¼nÃ¼ Ã–zel TasarÄ±m COL category VAL Maskara	1
COL name VAL Loreal Paris L'orÃ©al Paris Bambi Eye Ceylan GÃ¶z Etkili Maskara, Siyah, 8.9 ml COL category VAL Maskara	COL name VAL L'oreal paris Bambi Eye Ceylan GÃ¶z Etkili Siyah Maskara 30175792 COL category VAL Maskara	0
COL name VAL Loreal Paris Paradise Intense Black Ekstra Siyah Maskara x 2 COL category VAL Maskara	COL name VAL L'oreal paris Lash Paradise Intense Black Ekstra Siyah Maskara COL category VAL Maskara	0
COL name VAL L'OrÃ©al Paris Infaillible 24H Matte Cover YÃ¼ksek KapatÄ±cÄ± FondÃ¶ten - 200 Golden Sand COL category VAL Likit	COL name VAL L'oreal paris Infaillible 24H Matte Cover YÃ¼ksek KapatÄ±cÄ± FondÃ¶ten 200 Golden Sand 3600523784455 COL category VAL FondÃ¶ten	1
COL name VAL L'oreal paris Infaillible 24h Matte 30 Honey 35 ml Mat FondÃ¶ten -3600522875413 COL category VAL nan	COL name VAL L'OrÃ©al Paris Infaillible 24H Matte FondÃ¶ten 30 Miel Honey COL category VAL Loreal FondÃ¶ten	1
COL name VAL L'oreal paris Mat Ruj - Infallible Matte Rouge 007 Say My Name 3600522869252 COL category VAL nan	COL name VAL L'OrÃ©al Paris Infaillible Matte Max Ruj 007 SAY MY NAME COL category VAL Rujlar	1
COL name VAL L'oreal paris Volume Million Lashes Fatale Maskara Siyah 9.4 ml COL category VAL Maskara	COL name VAL L'oreal Volume Million Lashes Mascara Fatale Black COL category VAL Maskara	1
COL name VAL L'oreal paris Ruj - Color Riche Lipstick 703 Oud Obsession 3600522891475 COL category VAL nan	COL name VAL L'OrÃ©al Paris Color Riche Ruj 703 OUD OBSESSION COL category VAL Rujlar	1
COL name VAL Loreal Paris Superliner Silkissime 03 Moonlight Blue COL category VAL Eyeliner	COL name VAL Loreal botanicals Loreal Paris Superliner Silkissime 03 Moonlight Blue COL category VAL Dudak MakyajÄ±	0
COL name VAL Loreal Paris L'oreal Paris Telescopic Mascara Maskara COL category VAL Maskara	COL name VAL L'oreal paris Mascara Telescopic Black._ COL category VAL Maskara	0
COL name VAL Loreal Paris L'oreal Paris Rouge Signature Likit Mat Ruj - 103 Enjoy Ruj COL category VAL Rujlar	COL name VAL L'oreal paris Likit Mat Ruj - Rouge Signature COL category VAL Dudak MakyajÄ±	0
COL name VAL L'OrÃ©al Paris Color Riche Matte Addiction Ruj 358 Lava - KÄ±rmÄ±zÄ± COL category VAL Rujlar	COL name VAL L'oreal paris Mat Ruj - Color Riche Matte Addiction 358 Lava 3600523584789 COL category VAL Dudak MakyajÄ±	1
COL name VAL L'OrÃ©al Paris Color Queen Tekli GÃ¶z FarÄ± 06 Ferocious COL category VAL GÃ¶z FarÄ±	COL name VAL L'oreal paris Tekli GÃ¶z FarÄ± - Color Queen Mono Eyeshadow 06 Ferocious 30173040 COL category VAL GÃ¶z FarÄ±	1
COL name VAL L'Oreal Paris GÃ¶z Kalemi No 107 Kot Mavisi COL category VAL L"Oreal Paris GÃ¶z Kalemi	COL name VAL L'oreal paris Lacivert GÃ¶z Kalemi - Contour Khol Kajal 138 Blue Denim 3600520076560 COL category VAL nan	1
COL name VAL Loreal Paris Loreal Micellar Makyaj Temizleyici Bambi Maskara Seti COL category VAL Maskara	COL name VAL L'oreal paris Loreal Micellar Makyaj Temizleyici Air Volume Maskara Seti COL category VAL Maskara	0
COL name VAL L'OrÃ©al Paris Color Riche Shine Ruj 470 Map to Nirvana - Mor COL category VAL Rujlar	COL name VAL L'oreal paris Color Riche Shine Addiction Lipstick 470 Map To Nirvana 3600523518753 COL category VAL nan	1
COL name VAL Loreal Paris Loreal KapatÄ±cÄ± Paris True Match Magic KapatÄ±cÄ± No: 5n COL category VAL KapatÄ±cÄ±	COL name VAL L'oreal paris True Match MagÄ±c 5n KapatÄ±cÄ± COL category VAL Makyaj	0
COL name VAL L'OrÃ©al Paris True Match Pudra 3.R/3.C Rose Beige COL category VAL YÃ¼z	COL name VAL L'oreal paris Pudra - True Match Powder 3.R/3.C Rose Beige 3600520772028 COL category VAL Makyaj	1
COL name VAL Loreal Paris True Match Nude Serum FondÃ¶ten 0.5-2 Very Light COL category VAL Likit	COL name VAL L'oreal paris Loreal True Match Nude Serum FondÃ¶ten Very Light FondÃ¶ten FÄ±rÃ§asÄ± Seti COL category VAL FondÃ¶ten	0
COL name VAL L'Oreal Paris Infaillible Eye Paint GÃ¶z FarÄ± 102 Irresistible COL category VAL L"Oreal Paris GÃ¶z FarÄ±	COL name VAL L'oreal paris GÃ¶z FarÄ± - Infallible Eyeshadow Paint 102 Irresistible 3600523240821 COL category VAL GÃ¶z FarÄ±	1
COL name VAL L'oreal paris L'orÃ©al Paris Paradise Suya DayanÄ±klÄ± Siyah Maskara COL category VAL Maskara	COL name VAL L'OrÃ©al Paris Paradise Suya DayanÄ±klÄ± Siyah Maskara COL category VAL Loreal Paris Maskara & Rimel	1
COL name VAL L'OrÃ©al Paris Infaillible Lip Paint Likit Ruj Lacquer 103 Fuschia Wars COL category VAL Rujlar	COL name VAL L'oreal paris Likit Ruj - Infallible Lip Paint Lacquer 103 Fuchsia Wars COL category VAL Dudak MakyajÄ±	0
COL name VAL L'OrÃ©al Paris Color Riche Matte Addiction Ruj 101 Candy Stiletto - Pembe COL category VAL Rujlar	COL name VAL L'oreal paris Color Riche Ruj Matte Addiction 101 Candy Stiletto COL category VAL Dudak MakyajÄ±	1
COL name VAL L'oreal paris L'orÃ©al Paris True Match BakÄ±m Yapan FondÃ¶ten 1r Rose Ivory & True Match KapatÄ±cÄ± 1n Ivory COL category VAL FondÃ¶ten	COL name VAL L'oreal Paris True Match BakÄ±m Yapan FondÃ¶ten 1n Ivory FondÃ¶ten COL category VAL Krem	0
COL name VAL L'oreal paris L'orÃ©al Paris True Match BakÄ±m Yapan FondÃ¶ten 5d Golden Sand COL category VAL FondÃ¶ten	COL name VAL L'OrÃ©al Paris True Match BakÄ±m Yapan FondÃ¶ten 5R ROSE SAND COL category VAL Krem	0
COL name VAL L'OrÃ©al Paris True Match BakÄ±m Yapan FondÃ¶ten 5R ROSE SAND COL category VAL Krem	COL name VAL L'oreal paris L'orÃ©al Paris True Match BakÄ±m Yapan FondÃ¶ten 7r Rose Amber COL category VAL FondÃ¶ten	0
COL name VAL L'oreal paris L'OrÃ©al Paris True Match BakÄ±m Yapan FondÃ¶ten 1.5 Linen COL category VAL nan	COL name VAL L'OrÃ©al Paris True Match BakÄ±m Yapan FondÃ¶ten 5N SAND COL category VAL Krem	0
COL name VAL L'OrÃ©al Paris Infaillible TÃ¼m YÃ¼ze Uygulanabilir KapatÄ±cÄ± 330 Pecan COL category VAL KapatÄ±cÄ±	COL name VAL L'oreal paris L'OrÃ©al Paris Infaillible 24H TÃ¼m YÃ¼ze Uygulanabilir KapatÄ±cÄ± - 326 Vanilla COL category VAL Makyaj	0
COL name VAL L'oreal paris L'orÃ©al Paris Unlimited KaldÄ±rma Etkili Siyah Maskara 7,4 Ml COL category VAL Maskara	COL name VAL L'OrÃ©al Paris Unlimited  KaldÄ±rma Etkili Siyah Maskara 7,4 ml COL category VAL Loreal Paris Maskara & Rimel	1
COL name VAL L'oreal paris Likit Mat Ruj - Rouge Signature 103 Enjoy 3600523543786 COL category VAL Dudak MakyajÄ±	COL name VAL L'OrÃ©al Paris Rouge Signature Likit Mat Ruj - 103 I Enjoy COL category VAL Rujlar	1
COL name VAL L'oreal paris Infaillible 24h Matte FondÃ¶ten 11 VanÄ±lle COL category VAL FondÃ¶ten	COL name VAL L'OrÃ©al Paris Infaillible 24H Matte FondÃ¶ten 11 VANILLE COL category VAL Likit	1
COL name VAL L'OrÃ©al Paris Color Riche Matte Addiction Ruj 346 Scarlet Silhouette - KÄ±rmÄ±zÄ± COL category VAL Rujlar	COL name VAL L'oreal paris Mat Ruj - Color Riche Matte Addiction Lipstick 346 Scarlet Silhouette 3600523399871 COL category VAL nan	1
COL name VAL L'oreal paris Ruj - Color Riche Free The Nudes 08 No Lies COL category VAL Dudak MakyajÄ±	COL name VAL L'oreal Paris Color Riche Free The Nudes Ruj - No Pressure COL category VAL Rujlar	0
COL name VAL L'oreal paris Tekli GÃ¶z FarÄ± - Color Queen Mono Eyeshadow 39 Iconic, 30173378 COL category VAL nan	COL name VAL L'OrÃ©al Paris Color Queen Tekli GÃ¶z FarÄ± 39 Iconic COL category VAL GÃ¶z FarÄ±	1
COL name VAL Loreal Paris Lâ€™orÃ©al Paris Uzun SÃ¼re KalÄ±cÄ± KaÅŸ Jeli Unbelieva Brow - 108 Dark Brunette COL category VAL KaÅŸ MakyajÄ±	COL name VAL L'oreal paris Unbelieva Brow Uzun SÃ¼re KalÄ±cÄ± KaÅŸ Jeli - 108 Dark Brunette COL category VAL KaÅŸ Kalemi&KaÅŸ FarÄ±	0
COL name VAL L'OrÃ©al Paris Color Riche Dudak Kalemi 285 PINK FEVER- Pembe COL category VAL Dudak Kalemleri	COL name VAL L'oreal paris Dudak Kalemi - Color Riche Crayon Liner 285 Pink Fever 3600522860730 COL category VAL Dudak MakyajÄ±	1
COL name VAL L'orÃ©al Paris Telescopic Carbon Black Maskara - Siyah 2'li Set COL category VAL Maskara	COL name VAL L'oreal paris Telescopic Carbon Extra Black Maskara - Siyah COL category VAL Maskara	0
COL name VAL L'oreal paris Infaillible Matte Lip Crayon Kalem Mat Ruj - 110 Caramel Rebel COL category VAL Dudak MakyajÄ±	COL name VAL Loreal Paris Ruj Kalem Matte LÄ±p Crayon 110 Caramel Rebel COL category VAL Rujlar	1
COL name VAL L'oreal paris Color Riche Ruj Matte Addiction 101 Candy Stiletto COL category VAL Dudak MakyajÄ±	COL name VAL L'OrÃ©al Paris Color Riche Matte Addiction Ruj 101 Candy Stiletto - Pembe COL category VAL Rujlar	1
COL name VAL L'OrÃ©al Paris Brow Artist Shaper KaÅŸ Kalemi 02 Blonde COL category VAL KaÅŸ MakyajÄ±	COL name VAL L'oreal paris AÃ§Ä±k Kahverengi KaÅŸ Kalemi - Brow Artist Superliner 02 Blonde 3600522426806 COL category VAL nan	1
COL name VAL L'oreal paris Mat Eyeliner - Matte Signature Eyeliner 07 Copper 30175280 COL category VAL GÃ¶z MakyajÄ±	COL name VAL L'OrÃ©al Paris Matte Signature Eyeliner 07 Copper - Turuncu COL category VAL Eyeliner	1
COL name VAL L'oreal paris L'orÃ©al Paris Lash Paradise Siyah Maskara COL category VAL Maskara	COL name VAL Loreal Paris L'oreal Paris Paradise Maskara Siyah Maskara COL category VAL Maskara	0
COL name VAL L'oreal paris Ruj - Color Riche Exclusive Reds - Eva's Red 3600522760436 COL category VAL nan	COL name VAL L'OrÃ©al Paris Color Riche Ruj Exclusive Reds EVA'S PURE RED COL category VAL Rujlar	1
COL name VAL L'OrÃ©al Paris Infaillible Shaping Stick AydÄ±nlatÄ±cÄ± 501 Oh my Jewels COL category VAL AydÄ±nlatÄ±cÄ±lar	COL name VAL L'oreal paris Stick AydÄ±nlatÄ±cÄ± - Infaillible Shaping Stick 501 Oh My Jewels 3600523533480 COL category VAL nan	1
COL name VAL L'oreal paris Kahverengi GÃ¶z Kalemi - Contour Khol Kajal 102 Espresso 3054080046967 COL category VAL GÃ¶z Kalemi	COL name VAL Loreal Paris Color Riche Lekhol GÃ¶z Kalemi-102 Pure Expresso COL category VAL GÃ¶z Kalemi	1
COL name VAL L'oreal paris TÃ¼m YÃ¼ze Uygulanabilir KapatÄ±cÄ± - Infaillible More Than Concealer 332 Amber COL category VAL nan	COL name VAL L'OrÃ©al Paris Infaillible TÃ¼m YÃ¼ze Uygulanabilir KapatÄ±cÄ± 332 Amber COL category VAL Kozmetik KiÅŸisel BakÄ±m	1
COL name VAL L'OrÃ©al Paris Color Riche Ruj Sevgililer ve KadÄ±nlar GÃ¼nÃ¼ Ã–zel TasarÄ±m COL category VAL Rujlar	COL name VAL L'oreal paris Color Riche Ruj Sevgililer ve KadÄ±nlar GÃ¼nÃ¼ Ã–zel TasarÄ±m 3600523898220 COL category VAL Dudak MakyajÄ±	1
COL name VAL L'OrÃ©al Paris Infaillible Shaping Stick FondÃ¶ten 190 Beige Dore COL category VAL Likit	COL name VAL L'oreal paris Paris Stick FondÃ¶ten 190 Beige Dore COL category VAL FondÃ¶ten	1
COL name VAL L'oreal paris Stick AllÄ±k - Infaillible Shaping Stick AllÄ±k 001 Sexy Flush 3600523532933 COL category VAL AllÄ±k	COL name VAL Loreal Paris Stick AllÄ±k - Infaillible Shaping Stick AllÄ±k 001 Sexy Flush 3600523532933 COL category VAL AllÄ±klar	1
COL name VAL L'oreal paris Telescopic Maskara - Siyah COL category VAL Maskara	COL name VAL Loreal Paris L'oreal Paris Telescopic Carbon Siyah Maskara Maskara COL category VAL Maskara	0
COL name VAL L'OrÃ©al Paris Skin Perfection Cilt KusursuzlaÅŸtÄ±rÄ±cÄ± 5'I 1 Arada BB Krem AÃ§Ä±k Ton COL category VAL BB Kremler	COL name VAL L'oreal paris BB Krem AÃ§Ä±k Ton - Skin Perfection BB Cream Light Spf 25 50ml 3600522456421 COL category VAL nan	1
COL name VAL L'OrÃ©al Paris Les Macarons Likit Mat Ruj 834 Infinite Spice COL category VAL Rujlar	COL name VAL L'oreal paris Likit Mat Ruj - Les Macarons Ultra Matte Liquid Lipstick 834 Infinite Spice 3600523729036 COL category VAL Dudak MakyajÄ±	1
COL name VAL L'oreal paris L'orÃ©al Paris True Match BakÄ±m Yapan FondÃ¶ten 4n BeÄ±ge COL category VAL FondÃ¶ten	COL name VAL L'OrÃ©al Paris True Match BakÄ±m Yapan FondÃ¶ten 4.5N True BeÄ±ge COL category VAL Likit	0
COL name VAL Loreal botanicals Loreal Paris Infallible Longwear Lip Liner 001 Highlight On Point COL category VAL Dudak MakyajÄ±	COL name VAL Loreal Paris Infallible Longwear Lip Liner 001 Highlight On Point COL category VAL Dudak Kalemleri	0
COL name VAL L'orÃ©al Paris Bambi Eye Oversized Ceylan GÃ¶z Etkili Maskara - Siyah COL category VAL Maskara	COL name VAL L'oreal paris Bambi Eye Ceylan GÃ¶z Etkili Maskara  Siyah COL category VAL Maskara	0
COL name VAL L'oreal Paris Micellar Makyaj Temizleme Suyu 400 Ml+ YÃ¼z Temizleme FÄ±rÃ§asÄ± COL category VAL Makyaj Temizleme ÃœrÃ¼nleri	COL name VAL L'oreal paris Micellar Fresh Makyaj Temizleme Suyu 400 ml COL category VAL Makyaj Temizleyici	0
COL name VAL L'oreal paris Pudra - True Match Powder 3.D 3.W Golden Beige 3600520772035 COL category VAL Makyaj	COL name VAL L'OrÃ©al Paris True Match Pudra 3.D/3.W Golden Beige COL category VAL Pudra	1
COL name VAL L'oreal paris Lash Paradise Waterproof Suya DayanÄ±klÄ± Maskara 6.4ml COL category VAL Maskara	COL name VAL Loreal Paris Lash Paradise Waterproof/suya DayanÄ±klÄ± Maskara 6.4ml COL category VAL Maskara	0
COL name VAL L'oreal Paris Color Riche Free The Nudes Ruj - No Pressure COL category VAL Rujlar	COL name VAL L'oreal paris Ruj - Color Riche Free The Nudes 08 No Lies COL category VAL Dudak MakyajÄ±	0
COL name VAL L'OrÃ©al Paris True Match BakÄ±m Yapan FondÃ¶ten 1.5 LÄ±nen COL category VAL Likit	COL name VAL L'oreal paris True Match BakÄ±m Yapan FondÃ¶ten 1.5 LINEN COL category VAL FondÃ¶ten	1
COL name VAL Loreal Paris L'oreal Paris True Match BakÄ±m Yapan FondÃ¶ten 4n Beige COL category VAL Krem	COL name VAL L'oreal paris L'orÃ©al Paris True Match BakÄ±m Yapan FondÃ¶ten 4n BeÄ±ge COL category VAL FondÃ¶ten	0
COL name VAL Loreal Paris Infaillible Lip Paint Likit Ruj Matte 207 Wuthering Purple COL category VAL Rujlar	COL name VAL L'oreal paris Infaillible Lip Paint Likit Ruj Matte 207 Wuthering Purple COL category VAL Dudak MakyajÄ±	0
COL name VAL L'OrÃ©al Paris Rouge Signature Metallic Likit Ruj - 201 Stupefy COL category VAL Rujlar	COL name VAL L'oreal paris Rouge Signature Metallic Likit Ruj 201 Stupefy COL category VAL Dudak MakyajÄ±	1
COL name VAL L'OrÃ©al Paris Mega Gloss Lip Gloss 404 RASPOUTINE ME COL category VAL Dudak ParlatÄ±cÄ±larÄ±	COL name VAL L'oreal paris Ruj - Infallible Mega Gloss 404 Raspoutine Me 3600522996736 COL category VAL Ruj	1
COL name VAL L'Oreal Paris GÃ¶z Kalemi No 108 Portofino Mavisi COL category VAL L"Oreal Paris GÃ¶z Kalemi	COL name VAL L'oreal paris Mavi GÃ¶z Kalemi - Contour Khol Portofino Blue 3600522199847 COL category VAL nan	1
COL name VAL L'OrÃ©al Paris True Match BakÄ±m Yapan FondÃ¶ten 4.5N True BeÄ±ge COL category VAL Likit	COL name VAL L'oreal paris L'orÃ©al Paris True Match BakÄ±m Yapan FondÃ¶ten 4n BeÄ±ge COL category VAL FondÃ¶ten	0
COL name VAL L'Oreal Paris Anti Age Serumlu Ruj S502 COL category VAL L"Oreal Paris Ruj	COL name VAL L'OrÃ©al Paris Color Riche Serum Ruj Renk: S502 True Red COL category VAL Rujlar	1
COL name VAL L'Oreal Paris Ruj No: 238 COL category VAL L"Oreal Paris Ruj	COL name VAL L'oreal paris Ruj - Color Riche Lipstick 238 Orange After 3600522851134 COL category VAL nan	1
COL name VAL L'OrÃ©al Paris Superliner Smokissime Eyeliner BLACK COL category VAL Eyeliner	COL name VAL Loreal Paris Superliner Smokissime Eyeliner COL category VAL L"oreal Eyeliner & SÃ¼rme	1
COL name VAL L'OrÃ©al Paris Le Liner Signature GÃ¶z Kalemi 01 Noir Cashmere COL category VAL GÃ¶z Kalemi	COL name VAL L'oreal paris Le Liner Signature GÃ¶z Kalemi 01 Noir Cashmere 30176447 COL category VAL GÃ¶z Kalemi	1
COL name VAL L'OrÃ©al Paris Extraordinaire 101 Rose Melody COL category VAL Rujlar	COL name VAL L'oreal paris Likit Ruj - Color Riche L'Extraordinaire Lipstick 101 Rose Melody 3600522458227 COL category VAL nan	1
COL name VAL L'OrÃ©al Paris Infaillible TÃ¼m YÃ¼ze Uygulanabilir KapatÄ±cÄ± 326 Vanilla COL category VAL KapatÄ±cÄ±	COL name VAL L'oreal paris L'OrÃ©al Paris Infaillible TÃ¼m YÃ¼ze Uygulanabilir KapatÄ±cÄ± 338 Honey COL category VAL Makyaj	0
COL name VAL L'oreal paris Siyah Maskara - Volume Million Lashes Feline Mascara Black COL category VAL nan	COL name VAL L'OrÃ©al Paris Volume Million Lashes Carbon Black Maskara Siyah COL category VAL Maskara	0
COL name VAL L'oreal paris KaÅŸ Kalemi - Brow Artist High Contour 108 Warm Brown 3600523601684 COL category VAL nan	COL name VAL L'OrÃ©al Paris Brow Artist High Contour 105 Brunette - Kumral COL category VAL KaÅŸ MakyajÄ±	1
COL name VAL L'oreal paris Ruj - Infallible Mega Gloss 509 You Know You 3600522996866 COL category VAL nan	COL name VAL L'OrÃ©al Paris Mega Gloss Lip Gloss 509 YOU KNOW YOU LOVE ME COL category VAL Dudak ParlatÄ±cÄ±larÄ±	1
COL name VAL L'oreal paris Likit Mat Ruj - Rouge Signature 105 Rule 3600523543656 COL category VAL Dudak MakyajÄ±	COL name VAL L'Oreal Paris Rouge Signature Likit Mat Ruj 105 Rule COL category VAL L"Oreal Paris Ruj	1
COL name VAL L'oreal paris GÃ¶z FarÄ± Paleti - La Petite Palette Feminist 3600523556052 COL category VAL GÃ¶z FarÄ±	COL name VAL L'OrÃ©al Paris La Petite Far Paleti - Feminist COL category VAL GÃ¶z FarÄ±	1
COL name VAL L'oreal paris Mat Ruj - Color Riche Matte Addiction 655 Copper Clutch 3600523584741 COL category VAL Dudak MakyajÄ±	COL name VAL L'OrÃ©al Paris Color Riche Matte Addiction Ruj 655 Copper Clutch - Kahverengi COL category VAL Rujlar	1
COL name VAL L'OrÃ©al Paris La Petite Far Paleti - Optimist COL category VAL GÃ¶z FarÄ±	COL name VAL L'oreal paris GÃ¶z FarÄ± Paleti - La Petite Palette Optimist 3600523556038 COL category VAL GÃ¶z FarÄ±	1
COL name VAL L'orÃ©al Paris Cherie On The Cake AllÄ±k ve BronzlaÅŸtÄ±rÄ±cÄ± Pudra - 02 Dark Chocolate COL category VAL AllÄ±klar	COL name VAL L'oreal paris AllÄ±k & BronzlaÅŸtÄ±rÄ±cÄ± Pudra - Blush Cherie On The Cake & Bronzer 02 Dark Chocolate 3600523706778 COL category VAL AllÄ±k	1
COL name VAL L'Oreal Paris Color Queen Tekli GÃ¶z FarÄ± 29 Ruthless COL category VAL L"Oreal Paris GÃ¶z FarÄ±	COL name VAL L'oreal paris Tekli GÃ¶z FarÄ± - Color Queen Mono Eyeshadow 29 Ruthless 30173279 COL category VAL GÃ¶z FarÄ±	1
COL name VAL L'OrÃ©al Paris True Match BakÄ±m Yapan FondÃ¶ten 2R ROSE VANILLA COL category VAL Likit	COL name VAL L'oreal paris True Match BakÄ±m Yapan FondÃ¶ten 2R ROSE VANILLA COL category VAL FondÃ¶ten	1
COL name VAL Loreal Paris Lip Liner Couture By Color Riche 285 Pink Fever COL category VAL Dudak Kalemleri	COL name VAL Loreal botanicals Lip Liner Couture By Color Riche 285 Pink Fever COL category VAL Dudak MakyajÄ±	0
COL name VAL L'orÃ©al Paris True Match BakÄ±m Yapan FondÃ¶ten 1r Rose Ivory COL category VAL Likit	COL name VAL L'oreal paris True Match BakÄ±m Yapan FondÃ¶ten 1N IVORY COL category VAL FondÃ¶ten	0
COL name VAL L'oreal paris Lash Sensational Yelpaze Etkili Burgundy Brown Maskara COL category VAL Maskara	COL name VAL L'Oreal Paris Lash Sensational Yelpaze Etkili Maskara Burgundy Brown COL category VAL L"Oreal Paris Maskara & Rimel	1
COL name VAL L'OrÃ©al Paris Infaillible TÃ¼m YÃ¼ze Uygulanabilir KapatÄ±cÄ± 321 Eggshell COL category VAL KapatÄ±cÄ±	COL name VAL L'oreal paris Infaillible TÃ¼m YÃ¼ze Uygulanabilir KapatÄ±cÄ± 322 Ivory COL category VAL Makyaj	0
COL name VAL L'oreal paris BB Krem Orta Ton - Skin Perfection BB Cream Medium Spf 25 50 ml 3600522456438 COL category VAL BB ve CC Krem	COL name VAL L'OrÃ©al Paris Skin Perfection Cilt KusursuzlaÅŸtÄ±rÄ±cÄ± 5'I 1 Arada BB Krem Orta Ton COL category VAL BB Kremler	1
COL name VAL Loreal Paris L'orÃ©al Paris True Match BakÄ±m Yapan FondÃ¶ten 1r Rose Ivory, 30 ml COL category VAL Krem	COL name VAL L'oreal paris True Match BakÄ±m Yapan FondÃ¶ten 1N IVORY COL category VAL FondÃ¶ten	0
COL name VAL L'orÃ©al Paris Color Riche Intense Volume Matte Ruj - 640 Nude Independant COL category VAL Rujlar	COL name VAL L'oreal paris Color Riche Intense Volume Matte Ruj - 640 Nude Independant & Ayna COL category VAL Dudak MakyajÄ±	0
COL name VAL L'OrÃ©al Paris Rouge Signature Empowereds Likit Mat Ruj - 141 Discovered COL category VAL Rujlar	COL name VAL L'oreal paris Rouge Signature Empowereds Likit Mat Ruj 141 Discovered 3600523799824 COL category VAL nan	1
COL name VAL L'oreal paris L'OrÃ©al Paris Infaillible 24H FondÃ¶ten 150 RADIANT BEIGE COL category VAL nan	COL name VAL L'OrÃ©al Paris Infaillible 24H FondÃ¶ten 150 RADIANT BEIGE COL category VAL Krem	1
COL name VAL L'oreal paris Likit Mat Ruj - Les Macarons Ultra Matte Liquid Lipstick 820 Praline De 3600523729111 COL category VAL Dudak MakyajÄ±	COL name VAL L'OrÃ©al Paris Les Macarons Likit Mat Ruj 820 Praline De Paris COL category VAL Rujlar	1
COL name VAL L'OrÃ©al Paris Infaillible 24H Matte Cover YÃ¼ksek KapatÄ±cÄ± FondÃ¶ten - 110 Rose Vanilla COL category VAL Likit	COL name VAL L'oreal paris Infaillible 24h Matte Cover YÃ¼ksek KapatÄ±cÄ± FondÃ¶ten 155 Natural Rose COL category VAL FondÃ¶ten	0
COL name VAL L'Oreal Paris Lumi Magique Concealer KapatÄ±cÄ± ve AydÄ±nlatÄ±cÄ± 02 Medium COL category VAL L"Oreal Paris KapatÄ±cÄ±	COL name VAL L'oreal paris KapatÄ±cÄ± & AydÄ±nlatÄ±cÄ± AÃ§Ä±k - Lumimagic Highlighter Pen 01 Light 3600522080411 COL category VAL nan	1
COL name VAL L'oreal paris Infaillible Matte Lip Crayon Kalem Mat Ruj - 108 Hot Apricot COL category VAL Dudak MakyajÄ±	COL name VAL Loreal Paris Loreal Matte Lip Crayon Mat Kalem Ruj No 108 COL category VAL Rujlar	1
COL name VAL Loreal Paris L'oreal Paris Loreal Paris Air Volume Waterproof Suya DayanÄ±klÄ± Maskara Maskara COL category VAL Maskara	COL name VAL L'oreal paris Loreal Air Volume Easy Waterproof Suya DayanÄ±klÄ± Maskara Siyah COL category VAL Maskara	0
COL name VAL L'oreal paris Kahverengi Eyeliner  Infallible Stylo Eyeliner 24h 320 Nude Obsession 3600523163496 COL category VAL GÃ¶z MakyajÄ±	COL name VAL L'OrÃ©al Paris Infaillible 24H GÃ¶z Kalemi 320 NUDE OBSESSION COL category VAL Eyeliner	1
COL name VAL Loreal Paris Telescopic Carbon Black Maskara - Siyah Maskara COL category VAL Maskara	COL name VAL Loreal Paris Telescopic Carbon Black Maskara - Siyah COL category VAL Loreal Paris Maskara & Rimel	1
COL name VAL L'OrÃ©al Paris Color Riche Ruj 335 CARMIN ST GERMAIN COL category VAL Rujlar	COL name VAL L'oreal paris Ruj - Color Riche Lipstick 335 Carmin Saint 3600522851165 COL category VAL Dudak MakyajÄ±	1
COL name VAL L'oreal paris Siyah Maskara - Volume Million Lashes Feline Mascara Black 3600523033942 COL category VAL Maskara	COL name VAL L'OrÃ©al Paris Volume Million Lashes Feline Maskara COL category VAL Maskara	1
COL name VAL L'oreal paris Le Khol  Immaculate Snow GÃ¶z Kalemi 120 3600523409358 COL category VAL GÃ¶z Kalemi	COL name VAL L'OrÃ©al Paris Contour Khol GÃ¶z Kalemi 120 Immaculate Snow COL category VAL GÃ¶z Kalemi	1
COL name VAL L'oreal paris Tekli GÃ¶z FarÄ± - Color Queen Mono Eyeshadow 24 Excessive 30173224 COL category VAL GÃ¶z FarÄ±	COL name VAL L'OrÃ©al Paris Color Queen Tekli GÃ¶z FarÄ± 24 Excessive COL category VAL GÃ¶z FarÄ±	1
COL name VAL L'OrÃ©al Paris True Match BakÄ±m Yapan FondÃ¶ten 4D GOLDEN NATURAL COL category VAL Likit	COL name VAL L'oreal paris L'orÃ©al Paris True Match BakÄ±m Yapan FondÃ¶ten 5d Golden Sand COL category VAL FondÃ¶ten	0
COL name VAL L'oreal paris True Match GÃ¶z Kremi Ä°Ã§eren KapatÄ±cÄ±  2'si 1 Arada  1-2R Rose Porcelain COL category VAL Makyaj	COL name VAL Loreal Paris True Match GÃ¶z Kremi IÃ§eren KapatÄ±cÄ± Rose Porcelain COL category VAL KapatÄ±cÄ±	0
COL name VAL Loreal Paris Loreal True Match Nude Serum FondÃ¶ten Very Light FondÃ¶ten FÄ±rÃ§asÄ± Seti COL category VAL Likit	COL name VAL L'oreal paris Loreal True Match Nude Serum FondÃ¶ten Very Light FondÃ¶ten FÄ±rÃ§asÄ± Seti COL category VAL FondÃ¶ten	0
COL name VAL L'OrÃ©al Paris Brow Artist Xpert No 106 Grey Brunette COL category VAL KaÅŸ MakyajÄ±	COL name VAL L'oreal paris KaÅŸ Kalemi - Brow Artist Xpert 106 Grey Brune 3600523352845 COL category VAL KaÅŸ Kalemi&KaÅŸ FarÄ±	1
COL name VAL Loreal Paris Infaillible Shaping Stick AllÄ±k 001 Sexy Flush COL category VAL AllÄ±klar	COL name VAL L'oreal paris Stick AllÄ±k - Infaillible Shaping Stick AllÄ±k 001 Sexy Flush 3600523532933 COL category VAL AllÄ±k	1
COL name VAL Loreal Paris True Match FondÃ¶ten 3n Creamy Beige COL category VAL Krem	COL name VAL L'oreal paris True Match BakÄ±m Yapan FondÃ¶ten 3N CREAMY BEIGE COL category VAL FondÃ¶ten	0
COL name VAL L'OrÃ©al Paris Infaillible 24H FondÃ¶ten 145 BEIGE ROSE COL category VAL FondÃ¶ten	COL name VAL L'oreal paris Loreal ParÄ±s InfallÄ±ble 145 Beige Rose 3600520761930 COL category VAL nan	1
COL name VAL L'oreal paris Mascara Telescopic Black._ COL category VAL Maskara	COL name VAL L'OrÃ©al Paris Mascara Telescopic Black COL category VAL Maskara	0
COL name VAL L'oreal paris True Match BakÄ±m Yapan FondÃ¶ten 0.5n PorcelaÄ±n COL category VAL FondÃ¶ten	COL name VAL L'OrÃ©al Paris True Match BakÄ±m Yapan FondÃ¶ten 0.5N PorcelaÄ±n COL category VAL Likit	1
COL name VAL L'Oreal Paris Les Macarons Ultra Matte Likit Ruj 826 Mademoise COL category VAL L"Oreal Paris ParlatÄ±cÄ± & DolgunlaÅŸtÄ±rÄ±cÄ±	COL name VAL L'oreal paris Likit Mat Ruj - Les Macarons Ultra Matte Liquid Lipstick 826 Mademoiselle Mango 3600523729098 COL category VAL nan	1
COL name VAL Loreal Paris Infallible Mattifying Base Primer COL category VAL Makyaj BazlarÄ±	COL name VAL L'Oreal Paris Infaillible Resurfacing GÃ¶zenek Gizleyici ve PÃ¼rÃ¼zsÃ¼zleÅŸtirici Baz COL category VAL L"Oreal Paris Makyaj Baz & Sabitleyiciler	1
COL name VAL L'oreal paris Kahverengi GÃ¶z Kalemi - Contour Kohl 135 Brown 3054080046950 COL category VAL GÃ¶z Kalemi	COL name VAL L'OrÃ©al Paris Contour Khol GÃ¶z Kalemi 135 BROWN COL category VAL GÃ¶z Kalemi	1
COL name VAL L'oreal paris Rouge Signature Lip Topper 210 White Gold ParlatÄ±cÄ± Ruj 3600523690688 COL category VAL nan	COL name VAL L'OrÃ©al Paris Rouge Signature Lip Topper Dudak ParlatÄ±cÄ± Ruj - 210 White Gold COL category VAL Rujlar	1
COL name VAL L'oreal paris Brow Artist High Contour 109 Ebony KaÅŸ Kalemi - 3600523601691 COL category VAL KaÅŸ Kalemi&KaÅŸ FarÄ±	COL name VAL L'OrÃ©al Paris Brow Artist High Contour 109 Ebony - Esmer COL category VAL KaÅŸ MakyajÄ±	1
COL name VAL L'Oreal Paris Rouge Signature Matte Likit Ruj 113 Enjoy COL category VAL L"Oreal Paris ParlatÄ±cÄ± & DolgunlaÅŸtÄ±rÄ±cÄ±	COL name VAL L'oreal paris Likit Mat Ruj - Rouge Signature 103 Enjoy 3600523543786 COL category VAL Dudak MakyajÄ±	1
COL name VAL Loreal Paris Lâ€™orÃ©al Paris Uzun SÃ¼re KalÄ±cÄ± KaÅŸ Jeli Unbelieva Brow - 105 Brunette COL category VAL KaÅŸ MakyajÄ±	COL name VAL L'oreal paris Unbelieva Brow Uzun SÃ¼re KalÄ±cÄ± KaÅŸ Jeli -105 Brunette COL category VAL KaÅŸ Kalemi&KaÅŸ FarÄ±	1
COL name VAL L'oreal paris Mat Pudra - Infaillible 24H Ultra Matte Prestige Pudra 225 Beige 3600523499281 COL category VAL Makyaj	COL name VAL L'OrÃ©al Paris Infaillible 24H Ultra Matte Prestige Pudra-225 Beige COL category VAL Pudra	1
COL name VAL L'OrÃ©al Paris True Match BakÄ±m Yapan FondÃ¶ten 1D Golden Ivory COL category VAL Likit	COL name VAL L'oreal paris True Match BakÄ±m Yapan FondÃ¶ten 1R ROSE IVORY COL category VAL FondÃ¶ten	0
COL name VAL Loreal Paris L'orÃ©al Paris Infaillible Matte Lip Crayon Kalem Mat Ruj - 109 Flirty Toffee 1 Paket (1 x 1 COL category VAL Rujlar	COL name VAL L'oreal paris Infaillible Matte Lip Crayon Kalem Mat Ruj - 109 Flirty Toffee COL category VAL Dudak MakyajÄ±	0
COL name VAL L'oreal paris Ruj - Lip Paint Metallic 306 Lolita 3600523518289 COL category VAL nan	COL name VAL L'OrÃ©al Paris Infaillible Metallic Lip Paint 306 Lolita COL category VAL Rujlar	1
COL name VAL L'OrÃ©al Paris Infaillible TÃ¼m YÃ¼ze Uygulanabilir KapatÄ±cÄ± 322 Ivory COL category VAL KapatÄ±cÄ±	COL name VAL L'oreal paris Infaillible 24H TÃ¼m YÃ¼ze Uygulanabilir KapatÄ±cÄ± - 328 Lin COL category VAL Makyaj	0
COL name VAL L'oreal Paris Bambi Eye Waterproof Suya DayanÄ±klÄ± Ceylan GÃ¶z Etkili Maskara COL category VAL Maskara	COL name VAL L'oreal paris Loreal Bambi Eye Ceylan GÃ¶z Etkili Suya DayanÄ±klÄ± Siyah Maskara COL category VAL Maskara	1
COL name VAL Loreal True Match Foundation 1n Ivory FondÃ¶ten SÃ¼ngeri Seti COL category VAL Likit	COL name VAL L'oreal paris Loreal True Match Foundation 1rc Rose Ivory FondÃ¶ten SÃ¼ngeri Seti COL category VAL FondÃ¶ten	0
COL name VAL L'OrÃ©al Paris Color Riche Free The Nudes Ruj - No Diktat COL category VAL Rujlar	COL name VAL L'oreal paris Ruj - Color Riche Free The Nudes 03 No Doubts COL category VAL Dudak MakyajÄ±	1
COL name VAL L'oreal paris Merry Metals Superliner 03 Gold Eyeliner -3600523515752 COL category VAL nan	COL name VAL L'OrÃ©al Paris Merry Metals Superliner 03 Gold COL category VAL Eyeliner	1
COL name VAL L'oreal paris Makyaj BazÄ± InfaÄ±llÄ±ble MattfyÄ±ng COL category VAL Makyaj BazÄ±	COL name VAL L'Oreal Paris Infaillible Resurfacing GÃ¶zenek Gizleyici ve PÃ¼rÃ¼zsÃ¼zleÅŸtirici Baz COL category VAL L"Oreal Paris Makyaj Baz & Sabitleyiciler	1
COL name VAL L'OrÃ©al Paris Air Volume Mega Hacim Veren Maskara - Siyah COL category VAL Maskara	COL name VAL L'OrÃ©al Paris Air Volume Mega Hacim Veren Maskara - Siyah COL category VAL Loreal Paris Maskara & Rimel	1
COL name VAL L'OrÃ©al Paris Ã‡ift FazlÄ± Micellar Kusursuz Makyaj Temizleme Suyu COL category VAL Makyaj Temizleme ÃœrÃ¼nleri	COL name VAL L'oreal paris Ã‡ift FazlÄ± Micellar Kusursuz Makyaj Temizleme Suyu 400 Ml 3600523461202 COL category VAL nan	1
COL name VAL L'oreal paris True Match BakÄ±m Yapan FondÃ¶ten 3R ROSE BEIGE COL category VAL FondÃ¶ten	COL name VAL Loreal Paris L'oreal Paris True Match BakÄ±m Yapan FondÃ¶ten 4n Beige COL category VAL Krem	0
COL name VAL L'oreal paris Jel KaÅŸ PomadÄ± - Brow Artist Pomade No: 104 Brunette 30143654 COL category VAL KaÅŸ Kalemi&KaÅŸ FarÄ±	COL name VAL L'OrÃ©al Paris Brow Artist Paradise KaÅŸ PomadÄ± 104 Brunette - Kumral COL category VAL KaÅŸ MakyajÄ±	1
COL name VAL L'OrÃ©al Paris Infaillible 24H Matte Cover YÃ¼ksek KapatÄ±cÄ± FondÃ¶ten - 155 Natural Rose COL category VAL Likit	COL name VAL L'oreal paris Infaillible 24h Matte Cover YÃ¼ksek KapatÄ±cÄ± FondÃ¶ten 155 Natural Rose 3600523784417 COL category VAL FondÃ¶ten	1
COL name VAL L'Oreal Paris Color Richa Ultra Matte Mat Ruj No: 6 Hesitation COL category VAL L"Oreal Paris Ruj	COL name VAL L'oreal paris Ruj - Color Riche Free The Nudes 03 No Doubts COL category VAL Dudak MakyajÄ±	1
COL name VAL L'Oreal Paris True Match BakÄ±m Yapan FondÃ¶ten 1.5 LÄ±nen COL category VAL Loreal Paris FondÃ¶ten	COL name VAL L'oreal paris True Match BakÄ±m Yapan FondÃ¶ten 1.5 LÄ±nen COL category VAL FondÃ¶ten	1
COL name VAL L'OrÃ©al Paris Color Queen Tekli GÃ¶z FarÄ± 02 Force COL category VAL GÃ¶z FarÄ±	COL name VAL L'oreal paris Tekli GÃ¶z FarÄ± - Color Queen Mono Eyeshadow 02 Force 30173002 COL category VAL GÃ¶z FarÄ±	1
COL name VAL L'oreal paris L'OrÃ©al Paris Infaillible 24H TÃ¼m YÃ¼ze Uygulanabilir KapatÄ±cÄ± - 326 Vanilla COL category VAL Makyaj	COL name VAL L'OrÃ©al Paris Infaillible TÃ¼m YÃ¼ze Uygulanabilir KapatÄ±cÄ± 326 Vanilla COL category VAL KapatÄ±cÄ±	1
COL name VAL Loreal Paris L'orÃ©al Paris Lash Paradise Intense Black Ekstra Siyah Maskara 1 Paket (1 x 23 G) COL category VAL Maskara	COL name VAL L'oreal paris Lash Paradise Intense Black Ekstra Siyah Maskara COL category VAL Maskara	0
COL name VAL L'orÃ©al Paris Bambi Eye Ceylan GÃ¶z Etkili Maskara, Siyah, 8.9 ml COL category VAL Eyeliner	COL name VAL L'oreal paris L'orÃ©al Paris Bambi Eye Oversized Ceylan GÃ¶z Etkili Maskara - Siyah COL category VAL Maskara	0
COL name VAL L'oreal paris Infaillible Shaping Stick Sexy Flush AllÄ±k 001 3600523532933 COL category VAL nan	COL name VAL Loreal Paris Infaillible Shaping Stick AllÄ±k 001 Sexy Flush COL category VAL AllÄ±klar	1
COL name VAL L'OrÃ©al Paris True Match BakÄ±m Yapan FondÃ¶ten - 7D Golden Amber COL category VAL Krem	COL name VAL L'oreal paris L'orÃ©al Paris True Match BakÄ±m Yapan FondÃ¶ten 7d Golden Amber COL category VAL FondÃ¶ten	1
COL name VAL L'oreal paris KapatÄ±cÄ± - True Match Concealer 4n Beige COL category VAL nan	COL name VAL L'OrÃ©al Paris True Match KapatÄ±cÄ± - 4N Beige COL category VAL KapatÄ±cÄ±lar	1
COL name VAL Loreal Paris L'oreal Paris Emotions Of Nu AllÄ±k Ve Far Paleti GÃ¶z FarÄ± COL category VAL GÃ¶z FarÄ±	COL name VAL L'oreal paris Emotions of Nu AllÄ±k & Far Paleti COL category VAL GÃ¶z FarÄ±	0
COL name VAL L'oreal paris KaÅŸ Kalemi - Brow Artist High Contour 103 Warm Blonde 3600523601653 COL category VAL nan	COL name VAL L'OrÃ©al Paris Brow Artist High Contour 103 Warm Blond - AÃ§Ä±k SarÄ±ÅŸÄ±n COL category VAL KaÅŸ MakyajÄ±	1
COL name VAL L'OrÃ©al Paris Infaillible Matte Max Ruj 008 I GOTTA FEELING COL category VAL Rujlar	COL name VAL L'oreal paris Mat Ruj - Infallible Matte Rouge 008 I Gotta Feeling COL category VAL Dudak MakyajÄ±	1
COL name VAL L'OrÃ©al Paris Infaillible TÃ¼m YÃ¼ze Uygulanabilir KapatÄ±cÄ± 330 Pecan COL category VAL KapatÄ±cÄ±	COL name VAL L'oreal paris L'OrÃ©al Paris Infaillible 24H TÃ¼m YÃ¼ze Uygulanabilir KapatÄ±cÄ± - 330 Pecan COL category VAL Makyaj	0
COL name VAL Loreal Paris Infaillable Lipgloss - 309 Sayonara Sunset COL category VAL Dudak ParlatÄ±cÄ±larÄ±	COL name VAL Loreal Paris Infaillable Lipgloss - 309 Sayonara Sunset COL category VAL Loreal Paris Ruj	1
COL name VAL L'OrÃ©al Paris Superliner Gel Matic 01 COL category VAL Eyeliner	COL name VAL L'oreal paris Super Liner Gelmatic 02 Deep Violet - Mor GÃ¶z Kalemi COL category VAL GÃ¶z Kalemi	1
COL name VAL L'oreal paris Color Riche Intense Volume Matte Ruj - 602 Nude Admirable & Ayna COL category VAL Dudak MakyajÄ±	COL name VAL L'orÃ©al Paris Color Riche Intense Volume Matte Ruj - 602 Nude Admirable COL category VAL Rujlar	0
COL name VAL Loreal Paris L'oreal Paris True Match BakÄ±m Yapan FondÃ¶ten 4n Beige COL category VAL Krem	COL name VAL L'oreal paris True Match BakÄ±m Yapan FondÃ¶ten 4.5n True BeÄ±ge COL category VAL FondÃ¶ten	0
COL name VAL Loreal Paris Volume Million Lashes Fatale Noir Black Maskara 9.4 ml COL category VAL Maskara	COL name VAL L'oreal paris Volume Million Lashes Feline Noir Black Maskara 9.2 ml COL category VAL Maskara	0
COL name VAL L'oreal paris L'orÃ©al Paris True Match Nude FondÃ¶ten Serum 2-3 Light COL category VAL FondÃ¶ten	COL name VAL Loreal Paris True Match Nude Serum FondÃ¶ten 2-3 Light COL category VAL Likit	1
COL name VAL L'oreal paris Stick FondÃ¶ten Infaillible Longwear Shaping Stick Foundation 220 Caramel 9 gr 3600523531554 COL category VAL nan	COL name VAL L'OrÃ©al Paris Infaillible Shaping Stick FondÃ¶ten 220 Caramel COL category VAL Krem	1
COL name VAL L'oreal paris Siyah  Paradise Maskara COL category VAL nan	COL name VAL L'OrÃ©al Paris Paradise Siyah Maskara COL category VAL Loreal Paris Maskara & Rimel	1
COL name VAL L'oreal paris Mat Ruj - Color Riche Matte Addiction Lipstick 103 Rose Clutch 3600523399796 COL category VAL Dudak MakyajÄ±	COL name VAL L'OrÃ©al Paris Color Riche Matte Addiction Ruj 103 Blush in a Rush - Pembe COL category VAL Rujlar	1
COL name VAL L'oreal paris Telescopic Siyah Maskara 2'li Set COL category VAL Maskara	COL name VAL Loreal Paris L'oreal Paris Telescopic Carbon Siyah Maskara Maskara COL category VAL Maskara	0
COL name VAL L'oreal paris AllÄ±k & BronzlaÅŸtÄ±rÄ±cÄ± Pudra - Blush Cherie On The Cake & Bronzer 02 Dark Chocolate 3600523706778 COL category VAL AllÄ±k	COL name VAL L'orÃ©al Paris Cherie On The Cake AllÄ±k ve BronzlaÅŸtÄ±rÄ±cÄ± Pudra - 02 Dark Chocolate COL category VAL AllÄ±klar	1
COL name VAL L'oreal paris L'orÃ©al Paris True Match Nude FondÃ¶ten Serum 0.5-2 Very Light COL category VAL FondÃ¶ten	COL name VAL Loreal Paris True Match Nude Serum FondÃ¶ten 0.5-2 Very Light COL category VAL Likit	1
COL name VAL L'OrÃ©al Paris Brow Artist Micro Tattoo 105 Brunette - Kumral COL category VAL KaÅŸ MakyajÄ±	COL name VAL L'oreal paris KaÅŸ Kalemi - Brow Artist Micro Tattoo 105 Brunette 3600523527175 COL category VAL KaÅŸ Kalemi&KaÅŸ FarÄ±	1
COL name VAL L'oreal paris L'orÃ©al Paris Color Riche Satin Ruj 143 Pink Pigalle COL category VAL Dudak MakyajÄ±	COL name VAL Loreal Paris Marka: L'oreal Paris Color Riche Satin Ruj 143 Pink Pigalle Kategori: Ruj COL category VAL Rujlar	0
COL name VAL L'oreal paris Bambi Eye Ceylan GÃ¶z Etkili Siyah Maskara 30175792 COL category VAL Maskara	COL name VAL L'oreal Paris Bambi Eye Extra Black Ceylan GÃ¶z Etkili Maskara Ekstra Siyah COL category VAL Maskara	0
COL name VAL L'oreal paris L'orÃ©al Paris True Match BakÄ±m Yapan FondÃ¶ten 7.5d Golden Chestnut COL category VAL nan	COL name VAL L'OrÃ©al Paris True Match BakÄ±m Yapan FondÃ¶ten 7.5D Golden Chestnut COL category VAL Likit	1
COL name VAL Loreal Paris True Match BakÄ±m Yapan FondÃ¶ten 2n Vanilla Kategori: FondÃ¶ten COL category VAL Krem	COL name VAL L'oreal paris True Match BakÄ±m Yapan FondÃ¶ten 2N VANILLA COL category VAL FondÃ¶ten	0
COL name VAL L'oreal paris Siyah Eyeliner - Ultra Precision Superliner 01 3054080005773 COL category VAL Eyeliner	COL name VAL L'OrÃ©al Paris Superliner Ultra Precision Siyah Eyeliner COL category VAL Eyeliner	1
COL name VAL L'oreal paris 24H Fresh Wear FondÃ¶ten 125 Natural Rose & KapatÄ±cÄ± 327 Cashmere + Makyaj Organizer 36005236145161 COL category VAL Makyaj	COL name VAL Loreal Paris 24H Fresh Wear FondÃ¶ten 125 Natural Rose & KapatÄ±cÄ± 327 Cashmere + Makyaj Organizer COL category VAL Likit	0
COL name VAL L'oreal paris Siyah Eyeliner - Superliner Perfect Slim 3600522059592 COL category VAL nan	COL name VAL L'OrÃ©al Paris Superliner Perfect Slim Siyah Eyeliner COL category VAL Eyeliner	1
COL name VAL L'oreal paris True Match BakÄ±m Yapan FondÃ¶ten 3N CREAMY BEIGE COL category VAL FondÃ¶ten	COL name VAL Loreal Paris True Match BakÄ±m Yapan FondÃ¶ten Creamy Beige Kategori: FondÃ¶ten COL category VAL Krem	0
COL name VAL L'OrÃ©al Paris Infaillible Dudak Kalemi 701 Stay Ultraviolet- Pembe COL category VAL Dudak Kalemleri	COL name VAL L'oreal paris Dudak Kalemi - Infaillible Lip Pencil 701 Stay Ultraviolet COL category VAL Dudak MakyajÄ±	1
COL name VAL L'oreal paris Jel Siyah Eyeliner - Gel Intenza 24H Gel Eyeliner 01 Pure Black 3600522059448 COL category VAL GÃ¶z MakyajÄ±	COL name VAL Loreal Paris L'orÃ©al Paris Superliner Gel Intenza Siyah Eyeliner COL category VAL Eyeliner	1
COL name VAL L'OrÃ©al Paris Infaillible 24H FondÃ¶ten 230 RADIANT HONEY COL category VAL Krem	COL name VAL L'oreal paris L'OrÃ©al Paris Infaillible 24H FondÃ¶ten 230 RADIANT HONEY COL category VAL nan	1
COL name VAL L'Oreal Paris Super LÄ±ner Black Lacquer Waterproof Eyeliner COL category VAL L"Oreal Paris Eyeliner	COL name VAL L'oreal paris Super Liner Black Lacquer Waterproof Eyeliner 6 Ml 3600522025252 COL category VAL nan	1
COL name VAL L'oreal paris Rouge Signature Parisian Sunset Likit Mat Ruj 132radiate COL category VAL Dudak MakyajÄ±	COL name VAL Loreal Paris L'orÃ©al Paris Rouge Signature Parisian Sunset Likit Mat Ruj, 132 I RadiateRuj COL category VAL Rujlar	0
COL name VAL L'OrÃ©al Paris True Match BakÄ±m Yapan FondÃ¶ten 1D Golden Ivory COL category VAL Likit	COL name VAL L'OrÃ©al Paris True Match BakÄ±m Yapan FondÃ¶ten - 1D Golden Ivory COL category VAL Loreal Paris FondÃ¶ten	1
COL name VAL L'Oreal Paris True Match Pudra N4 Beige COL category VAL L"Oreal Paris Pudra	COL name VAL L'OrÃ©al Paris True Match Powder W7 Cinnamon COL category VAL Pudra	1
COL name VAL L'OrÃ©al Paris Color Riche Plump & Shine Ruj 101 Nectarine Plump COL category VAL Rujlar	COL name VAL L'oreal paris Glow Paradise Ruj Balm-in-lipstick 244 Apricot Desire-kayÄ±sÄ±  3600523687114-244 COL category VAL Dudak MakyajÄ±	1
COL name VAL L'oreal paris Ruj - Color Riche Shine Naked Tans 659 Blow Your Glow - Nude 3600523597789 COL category VAL nan	COL name VAL L'OrÃ©al Paris Color Riche Shine Naked Tans Ruj 658 Topless - Nude COL category VAL Dudaklar	1
COL name VAL L'oreal paris KaÅŸ Kalemi - Brow Artist High Contour 107 Cool Brown 3600523601677 COL category VAL nan	COL name VAL L'OrÃ©al Paris Brow Artist High Contour 107 Cool Brunette - Koyu Kumral COL category VAL KaÅŸ MakyajÄ±	1
COL name VAL L'OrÃ©al Paris True Match BakÄ±m Yapan FondÃ¶ten 4N BeÄ±ge COL category VAL Likit	COL name VAL L'oreal paris L'orÃ©al Paris True Match BakÄ±m Yapan FondÃ¶ten 4n BeÄ±ge COL category VAL FondÃ¶ten	1
COL name VAL Loreal botanicals Lip Liner Couture By Color Riche 374 Intense Plum COL category VAL Dudak MakyajÄ±	COL name VAL Loreal Paris Lip Liner Couture By Color Riche 374 Intense Plum COL category VAL Dudak Kalemleri	0
COL name VAL L'oreal paris Lash Paradise Intense Black Ekstra Siyah Maskara 2'li Set ve Ayna COL category VAL Maskara	COL name VAL L'oreal Paris Lash Paradise Intense Black Ekstra Siyah Maskara COL category VAL Maskara	0
COL name VAL L'oreal paris Ruj - Color Riche Free The Nudes 01 No Obstacles 3600523747146 COL category VAL Dudak MakyajÄ±	COL name VAL L'Oreal Paris Cr Ultra Matte Ruj No: 01 Obstacle COL category VAL L"Oreal Paris Ruj	1
COL name VAL L'OrÃ©al Paris True Match Roller N4 Buff Beige COL category VAL Likit	COL name VAL L'oreal paris Loreal True Match Roll-on FondÃ¶ten N4 COL category VAL FondÃ¶ten	1
COL name VAL Loreal Paris L'orÃ©al Paris Air Volume Mega Easy Waterproof Suya DayanÄ±klÄ± Maskara - Siyah COL category VAL Maskara	COL name VAL L'oreal paris L'orÃ©al Paris Air Volume Mega Easy Waterproof Suya DayanÄ±klÄ± Maskara - Siyah COL category VAL Maskara	0
COL name VAL L'oreal paris True Match BakÄ±m Yapan FondÃ¶ten 4D GOLDEN NATURAL COL category VAL FondÃ¶ten	COL name VAL L'OrÃ©al Paris True Match BakÄ±m Yapan FondÃ¶ten 4D GOLDEN NATURAL COL category VAL Likit	1
COL name VAL Loreal Paris Loreal Micellar Makyaj Temizleyici Bambi Maskara Seti COL category VAL Maskara	COL name VAL L'oreal paris Loreal Micellar Makyaj Temizleyici Paradise Intense Maskara Seti COL category VAL Maskara	0
COL name VAL L'oreal paris True Match BakÄ±m Yapan FondÃ¶ten 2r Rose COL category VAL FondÃ¶ten	COL name VAL Loreal Paris L'oreal Paris True Match BakÄ±m Yapan FondÃ¶ten 4n Beige COL category VAL Krem	0
COL name VAL L'oreal paris True Match BakÄ±m Yapan FondÃ¶ten 1n Ivory COL category VAL FondÃ¶ten	COL name VAL L'OrÃ©al Paris True Match BakÄ±m Yapan FondÃ¶ten 1N Ivory COL category VAL Likit	1
COL name VAL L'Oreal  Paris True Match BakÄ±m Yapan FondÃ¶ten 4N Beige COL category VAL L"Oreal Paris FondÃ¶ten	COL name VAL L'oreal paris L'orÃ©al Paris True Match BakÄ±m Yapan FondÃ¶ten 4n BeÄ±ge COL category VAL FondÃ¶ten	1
COL name VAL L'orÃ©al Paris Color Riche Saten BitiÅŸli Ruj 143 Pink Pigalle - Pembe COL category VAL Rujlar	COL name VAL L'oreal paris L'orÃ©al Paris Color Riche Satin Ruj 143 Pink Pigalle COL category VAL Dudak MakyajÄ±	1
COL name VAL L'oreal paris L'orÃ©al Paris True Match BakÄ±m Yapan FondÃ¶ten 4n BeÄ±ge COL category VAL FondÃ¶ten	COL name VAL L'OrÃ©al Paris True Match BakÄ±m Yapan FondÃ¶ten 9N Truffe COL category VAL Likit	0
COL name VAL L'OrÃ©al Paris Infaillible 24H Matte FondÃ¶ten 30 Miel Honey COL category VAL Loreal FondÃ¶ten	COL name VAL L'oreal paris Infaillible 24h Matte 30 Honey 35 ml Mat FondÃ¶ten -3600522875413 COL category VAL nan	1
COL name VAL L'OrÃ©al Paris Rouge Signature Likit Mat Ruj - 109 I Savor COL category VAL Rujlar	COL name VAL L'oreal paris Likit Mat Ruj - Rouge Signature 109 Savor 3600523543694 COL category VAL Dudak MakyajÄ±	1
COL name VAL L'OrÃ©al Paris True Match BakÄ±m Yapan FondÃ¶ten 1R ROSE IVORY COL category VAL Likit	COL name VAL L'oreal paris True Match BakÄ±m Yapan FondÃ¶ten 1n Ivory COL category VAL FondÃ¶ten	0
COL name VAL L'OrÃ©al Paris True Match BakÄ±m Yapan FondÃ¶ten 5R ROSE SAND COL category VAL Krem	COL name VAL L'oreal paris L'orÃ©al Paris True Match BakÄ±m Yapan FondÃ¶ten 0.5r Rose PorcelaÄ±n COL category VAL FondÃ¶ten	0
COL name VAL L'Oreal Paris Les Chocolats Ultra Matte Likit Ruj 856 %70 Yum COL category VAL L"Oreal Paris ParlatÄ±cÄ± & DolgunlaÅŸtÄ±rÄ±cÄ±	COL name VAL L'oreal paris Les Chocolats Ultra Matte Liquid Lipstick 856 Yum 3600523643974 COL category VAL Dudak MakyajÄ±	1
COL name VAL L'oreal paris True Match BakÄ±m Yapan FondÃ¶ten 2R Rose Vanilla+True Match KapatÄ±cÄ± 2N Vanilla COL category VAL FondÃ¶ten	COL name VAL Loreal Paris L'oreal Paris True Match BakÄ±m Yapan FondÃ¶ten 2r Rose Vanilla COL category VAL Krem	0
COL name VAL L'oreal paris Siyah Bambi Eye Oversized Ceylan GÃ¶z Etkili Maskara COL category VAL Maskara	COL name VAL L'orÃ©al Paris Bambi Eye Oversized Ceylan GÃ¶z Etkili Maskara - Siyah COL category VAL Maskara	1
COL name VAL L'oreal paris Dudak Kalemi - Infaillible Lip Pencil 213 Stripped Brown 3600523492565 COL category VAL Dudak MakyajÄ±	COL name VAL L'OrÃ©al Paris Infaillible Dudak Kalemi 213 Stripped Brown- Kahverengi COL category VAL Dudak Kalemleri	1
COL name VAL L'Oreal Paris 302RC True Match Highlight AydÄ±nlatÄ±cÄ± Pudra COL category VAL L"Oreal Paris Pudra	COL name VAL L'oreal paris True Match 2+1 Vurgu BazlÄ± Pudra ParlatÄ±cÄ± Highlight 302r/302c 9g Ã–zel Koleksiyon COL category VAL Makyaj	1
COL name VAL L'OrÃ©al Paris Infallible Waterproof Gel Crayon Eyeliner 07 Flash Silver COL category VAL Eyeliner	COL name VAL L'oreal paris Paris Waterproof Crayon Eyeliner 07 Silver COL category VAL Dudak MakyajÄ±	1
COL name VAL L'oreal paris Maskara Volume MÄ±llÄ±on Lashes Extra Black COL category VAL Maskara	COL name VAL L'OrÃ©al Paris Volume Million Lashes Carbon Black Maskara Siyah COL category VAL Maskara	1
COL name VAL L'oreal paris GÃ¶z FarÄ± - Infallible Eyeshadow Paint 302 Immortal Black 3600523240906 COL category VAL nan	COL name VAL L'OrÃ©al Paris Infaillible Eye Paint GÃ¶z FarÄ± 302 Immortal Black COL category VAL GÃ¶z FarÄ±	1
COL name VAL L'OrÃ©al Paris Les Chocolats Likit Mat Ruj 862 Volupto Choco COL category VAL Rujlar	COL name VAL L'Oreal Paris Les Chocolats Likit Mat Ruj 862 Volupto Choco COL category VAL Loreal Ruj	1
COL name VAL Loreal Paris KaÅŸ Serumu Brow AsÄ±st Plumo & Set 108 Dark Brunette COL category VAL KaÅŸ MakyajÄ±	COL name VAL L'oreal paris Brow Artist Plump&set Renkli KaÅŸ Sabitleyici Maskara - 108 COL category VAL KaÅŸ Sabitleyici	1
COL name VAL L'OrÃ©al Paris Infaillible 24H Fresh Wear Pudra FondÃ¶ten 180 Rose Sand COL category VAL Pudra	COL name VAL L'oreal paris Infaillible 24h Fresh Wear Pudra FondÃ¶ten 180 Rose Sand COL category VAL Makyaj	1
COL name VAL L'Oreal Paris True Match BakÄ±m Yapan FondÃ¶ten 1d Golden Ivory COL category VAL FondÃ¶ten	COL name VAL L'OrÃ©al Paris True Match BakÄ±m Yapan FondÃ¶ten 1D Golden Ivory COL category VAL Likit	1
COL name VAL L'oreal paris Siyah  Paradise Maskara COL category VAL nan	COL name VAL L'OrÃ©al Paris Paradise Siyah Maskara COL category VAL Loreal Paris Maskara & Rimel	1
COL name VAL L'oreal paris Rouge Signature Parisian Sunset Likit Mat Ruj 132Radiate 3600523739080 COL category VAL Dudak MakyajÄ±	COL name VAL L'OrÃ©al Paris Rouge Signature Parisian Sunset Likit Mat Ruj - 132 I Radiate COL category VAL Rujlar	1
COL name VAL L'orÃ©al Paris True Match BakÄ±m Yapan FondÃ¶ten 1r Rose Ivory COL category VAL Likit	COL name VAL L'oreal paris L'orÃ©al Paris True Match BakÄ±m Yapan FondÃ¶ten 1r Rose Ivory & True Match KapatÄ±cÄ± 1n Ivory COL category VAL FondÃ¶ten	0
COL name VAL L'oreal paris True Match BakÄ±m Yapan FondÃ¶ten 1N IVORY COL category VAL FondÃ¶ten	COL name VAL Loreal Paris L'oreal Paris True Match BakÄ±m Yapan FondÃ¶ten 4n Beige COL category VAL Krem	0
COL name VAL L'oreal paris Mat Ruj - Color Riche Matte Addiction Lipstick 633 Moka Chic- Nude 3600523399789 COL category VAL Dudak MakyajÄ±	COL name VAL L'Oreal Paris Color Riche Matte Addiction MatÂ Ruj 633 Moka Chic COL category VAL L"Oreal Paris Ruj	1
COL name VAL Loreal Air Volume Mega Maskara+Kajal GÃ¶z Kalemi COL category VAL Maskara	COL name VAL Loreal Air Volume Mega Maskara+Kajal GÃ¶z Kalemi COL category VAL Loreal Paris Maskara & Rimel	1
COL name VAL L'oreal paris Mat Eyeliner - Matte Signature Eyeliner 04 Emeraude 30175259 COL category VAL GÃ¶z MakyajÄ±	COL name VAL L'OrÃ©al Paris Matte Signature Eyeliner 04 Emeraude - YeÅŸil COL category VAL Eyeliner	1
COL name VAL L'Oreal Paris Ruj No: 134 COL category VAL L"Oreal Paris Ruj	COL name VAL L'oreal paris Ruj - Color Riche Lipstick 134 Pink Panac 3600522851042 COL category VAL nan	1
COL name VAL L'OrÃ©al Paris Rouge Signature Likit Mat Ruj - 113 I don't COL category VAL Rujlar	COL name VAL L'oreal paris Rouge Signature Likit Mat Ruj - 113 I Don't COL category VAL Dudak MakyajÄ±	1
COL name VAL L'oreal paris Infaillible Shaping Stick Sexy Flush AllÄ±k 001 3600523532933 COL category VAL nan	COL name VAL Loreal Paris Stick AllÄ±k - Infaillible Shaping Stick AllÄ±k 001 Sexy Flush 3600523532933 COL category VAL AllÄ±klar	1
COL name VAL L'oreal paris Volume Million Lashes Feline Noir Black Maskara 9.2 ml COL category VAL Maskara	COL name VAL Loreal Paris Volume Million Lashes Fatale Noir Black Maskara 9.4 ml COL category VAL Maskara	0
COL name VAL Loreal Paris Volume Million Lashes Maskara COL category VAL Maskara	COL name VAL L'oreal paris Volume Million Lashes Balm Noir Maskara COL category VAL Maskara	0
COL name VAL L'oreal paris True Match BakÄ±m Yapan FondÃ¶ten 2r Rose COL category VAL FondÃ¶ten	COL name VAL L'OrÃ©al Paris True Match BakÄ±m Yapan FondÃ¶ten 1R ROSE IVORY COL category VAL Likit	0
COL name VAL L'OrÃ©al Paris Infaillible 24H Matte Cover YÃ¼ksek KapatÄ±cÄ± FondÃ¶ten - 145 Rose Beige COL category VAL Likit	COL name VAL L'oreal paris Infaillible 24H Matte Cover YÃ¼ksek KapatÄ±cÄ± FondÃ¶ten 145 Rose Beige 3600523784424 COL category VAL FondÃ¶ten	1
COL name VAL L'oreal paris GÃ¶z FarÄ± - Infallible Eyeshadow Paint 301 Pure Purple 3600523240890 COL category VAL nan	COL name VAL L'OrÃ©al Paris Infaillible Eye Paint GÃ¶z FarÄ± 301 Pure Purple COL category VAL GÃ¶z FarÄ±	1
COL name VAL L'oreal paris Micellar Makyaj Temizleme Suyu Normalden Ve Karmaya Hassas Ciltler IÃ§in 200 ml COL category VAL Makyaj Temizleyici	COL name VAL Loreal Paris L'oreal Paris Micellar Makyaj Temizleme Suyu Normalden Kuruya Hassas Ciltler IÃ§in 200 ml COL category VAL Makyaj Temizleme ÃœrÃ¼nleri	0
COL name VAL L'oreal paris True Match BakÄ±m Yapan FondÃ¶ten 9N TRUFFE COL category VAL nan	COL name VAL L'OrÃ©al Paris True Match BakÄ±m Yapan FondÃ¶ten 9N Truffe COL category VAL Likit	1
COL name VAL Loreal Paris L'orÃ©al Paris Telescopic Carbon Black Maskara, Siyah, 8 ml COL category VAL Maskara	COL name VAL L'oreal paris Telescopic Carbon Extra Black Maskara - Siyah COL category VAL Maskara	0
COL name VAL L'oreal paris L'OrÃ©al Paris Infaillible 24H TÃ¼m YÃ¼ze Uygulanabilir KapatÄ±cÄ± - 326 Vanilla COL category VAL Makyaj	COL name VAL L'OrÃ©al Paris Infaillible TÃ¼m YÃ¼ze Uygulanabilir KapatÄ±cÄ± 322 Ivory COL category VAL KapatÄ±cÄ±	0
COL name VAL L'oreal paris Bambi Eye Ceylan GÃ¶z Etkili Siyah Maskara COL category VAL Maskara	COL name VAL L'oreal Paris Bambi Eye Extra Black Ceylan GÃ¶z Etkili Maskara Ekstra Siyah COL category VAL Maskara	0
COL name VAL L'oreal paris Telescopic Siyah Maskara 2'li Set COL category VAL Maskara	COL name VAL Loreal Paris L'orÃ©al Paris Telescopic Maskara - Siyah 1 Paket COL category VAL Maskara	0
COL name VAL L'OrÃ©al Paris Infaillible 24H Concealer Pomade KapatÄ±cÄ± 02 Medium - Koyu Ton COL category VAL KapatÄ±cÄ±lar	COL name VAL L'oreal paris Paris Infaillible 24h Concealer Pomade KapatÄ±cÄ± 02 Medium COL category VAL Makyaj	1
COL name VAL L'OrÃ©al Paris Infaillible 24H FondÃ¶ten 300 Amber COL category VAL Krem	COL name VAL L'OrÃ©al Paris Infaillible 24H FondÃ¶ten - 300 Amber COL category VAL Loreal Paris FondÃ¶ten	1
COL name VAL L'oreal paris L'orÃ©al Paris Infaillible 2-step 24 Saat KalÄ±cÄ± Likit Ruj & Balm - 804 Metro-proof Rose COL category VAL Dudak MakyajÄ±	COL name VAL Loreal Paris Loeral Infaillable Lipstick 2 Steps 804-METRO Proo COL category VAL Rujlar	1
COL name VAL L'OrÃ©al Paris True Match Pudra 5.D/5.W Golden Sand COL category VAL Pudra	COL name VAL L'oreal paris L'orÃ©al Paris True Match Pudra W5 Golden Sand COL category VAL Makyaj	1
COL name VAL L'OrÃ©al Paris Infaillible 24H Matte FondÃ¶ten 30 Miel Honey COL category VAL Loreal FondÃ¶ten	COL name VAL L'oreal paris Infaillible 24h Matte FondÃ¶ten 30 MÄ±el Honey COL category VAL nan	1
COL name VAL L'oreal paris Unbelieva Brow Uzun SÃ¼re KalÄ±cÄ± KaÅŸ Jeli - 109 Ebony COL category VAL KaÅŸ Kalemi&KaÅŸ FarÄ±	COL name VAL Loreal Paris Lâ€™orÃ©al Paris Uzun SÃ¼re KalÄ±cÄ± KaÅŸ Jeli Unbelieva Brow - 105 Brunette COL category VAL KaÅŸ MakyajÄ±	0
COL name VAL L'oreal paris KapatÄ±cÄ± - True Match Concealer Golden Honey 3600523500246 COL category VAL KapatÄ±cÄ±	COL name VAL L'OrÃ©al Paris True Match KapatÄ±cÄ± 6D/W Golden Honey COL category VAL KapatÄ±cÄ±	1
COL name VAL L'OrÃ©al Paris Caresse Rouge - 202 Impulsive Fuschsia COL category VAL Rujlar	COL name VAL L'Oreal Paris Caresse Lipstick Ruj 202 COL category VAL L"Oreal Paris Ruj	1
COL name VAL L'oreal paris Gri Eyeliner - Infallible Gel Crayon Eyeliner 02 Grey 3600523351619 COL category VAL Eyeliner	COL name VAL L'OrÃ©al Paris Infaillible Paint Gel Crayon Eyeliner 02 Grey Fever COL category VAL Eyeliner	1
COL name VAL L'oreal paris L'OrÃ©al Paris True Match BakÄ±m Yapan FondÃ¶ten 1.5 Linen COL category VAL nan	COL name VAL L'OrÃ©al Paris True Match BakÄ±m Yapan FondÃ¶ten 1N Ivory COL category VAL Likit	0
COL name VAL Loreal Paris L'oreal Paris Infaillible 24H Matte Cover YÃ¼ksek KapatÄ±cÄ± FondÃ¶ten No: 300 Amber COL category VAL Krem	COL name VAL L'oreal paris Infaillible 24h Matte Cover YÃ¼ksek KapatÄ±cÄ± FondÃ¶ten 155 Natural Rose COL category VAL FondÃ¶ten	0
COL name VAL L'oreal paris Siyah Maskara Bambi Eye Oversized Black COL category VAL Maskara	COL name VAL L'OrÃ©al Paris Bambi Oversized Eye Siyah Maskara + Ayna COL category VAL Maskara	0
COL name VAL L'oreal paris Hacim Veren Siyah Maskara Volumissime Royale x10 COL category VAL Maskara	COL name VAL L'OrÃ©al Paris Volumissime Royale X10 Siyah Maskara COL category VAL Maskara	0
COL name VAL L'oreal paris Unlimited Maskara Siyah COL category VAL Maskara	COL name VAL Loreal Paris Unlimited Siyah Maskara 2'li Set COL category VAL Maskara	0
COL name VAL Loreal Paris L'orÃ©al Paris Bambi Eye Extra Black Ceylan GÃ¶z Etkili Maskara - Ekstra Siyah COL category VAL Maskara	COL name VAL L'oreal paris L'OrÃ©al Paris Bambi Eye Ceylan GÃ¶z Etkili Maskara - Siyah COL category VAL Maskara	0
COL name VAL L'oreal paris Pudra - True Match Powder N4 Beige 3600520932897 COL category VAL nan	COL name VAL L'OrÃ©al Paris True Match Powder W7 Cinnamon COL category VAL Pudra	1
COL name VAL L'OrÃ©al Paris Color Riche x Balmain Collection Rock Woman Mat Ruj 901 Rebellion COL category VAL Rujlar	COL name VAL L'oreal paris Color Riche Rock Woman Mat Ruj 901 Rebellion 3600523512843 COL category VAL nan	1
COL name VAL L'OrÃ©al Paris Color Riche Dudak Kalemi 461 Scarlet Rouge COL category VAL Dudak Kalemleri	COL name VAL L'oreal paris - Color Riche Crayon Liner 461 Scarlet Rouge 3600522860815 Dudak Kalemi COL category VAL Ruj	1
COL name VAL Loreal Paris L'orÃ©al Paris Lash Paradise Intense Black Ekstra Siyah Maskara COL category VAL Maskara	COL name VAL L'oreal paris Lash Paradise Intense Black Ekstra Siyah Maskara 3600523897308 COL category VAL Maskara	0
COL name VAL L'Oreal Paris Les Chocolats Ultra Matte Likit Ruj 868 Cacao Crush COL category VAL L"Oreal Paris ParlatÄ±cÄ± & DolgunlaÅŸtÄ±rÄ±cÄ±	COL name VAL L'oreal paris Likit Mat Ruj - Les Chocolats Ultra Matte Liquid Lipstick 868 Cacao Rush 3600523643806 COL category VAL Dudak MakyajÄ±	1
COL name VAL Loreal Paris L'oreal Paris Mega Volume Collagene 24H Siyah Maskara Maskara COL category VAL Maskara	COL name VAL L'oreal paris Mega Volume Collagene 24H Siyah Maskara COL category VAL Maskara	0
COL name VAL L'Oreal Paris True Match BakÄ±m Yapan FondÃ¶ten 4.5N True Beige COL category VAL L"Oreal Paris FondÃ¶ten	COL name VAL L'OrÃ©al Paris True Match BakÄ±m Yapan FondÃ¶ten 4.5N True BeÄ±ge COL category VAL Likit	1
COL name VAL L'OrÃ©al Paris Volume Million Lashes Carbon Black Maskara Siyah COL category VAL Maskara	COL name VAL L'oreal paris Siyah Maskara - Volume Million Lashes Feline Mascara Black COL category VAL nan	0
COL name VAL L'Oreal Paris Color Richa Ultra Matte Mat Ruj No: 6 Hesitation COL category VAL L"Oreal Paris Ruj	COL name VAL L'OrÃ©al Paris Color Riche Free The Nudes Ruj - No Doubts COL category VAL Rujlar	1
COL name VAL L'OrÃ©al Paris True Match KapatÄ±cÄ± 2R/C Rose Vanilla COL category VAL KapatÄ±cÄ±lar	COL name VAL L'oreal paris KapatÄ±cÄ± - True Match Concealer 2R/C Rose Vanilla 3600523500185 COL category VAL Makyaj	1
COL name VAL L'oreal paris AydÄ±nlatÄ±cÄ± Palet En Glow Warm Glow Air Volume Maskara Seti COL category VAL AydÄ±nlatÄ±cÄ±	COL name VAL Loreal Paris AydÄ±nlatÄ±cÄ± Palet En Glow Warm Glow Air Volume Maskara Seti COL category VAL AydÄ±nlatÄ±cÄ±lar	0
COL name VAL L'OrÃ©al Paris Bambi Oversized Eye Siyah Maskara + Ayna COL category VAL Maskara	COL name VAL L'oreal paris Siyah Maskara Bambi Eye Oversized Black COL category VAL Maskara	0
COL name VAL L'OrÃ©al Paris True Match BakÄ±m Yapan FondÃ¶ten 1R ROSE IVORY COL category VAL Likit	COL name VAL L'oreal paris L'OrÃ©al Paris True Match BakÄ±m Yapan FondÃ¶ten 5R ROSE SAND COL category VAL FondÃ¶ten	0
COL name VAL L'oreal paris True Match Prestige Pudra- 3D Golden Beige COL category VAL Makyaj	COL name VAL L'OrÃ©al Paris True Match Prestige Pudra- 3D Golden Beige COL category VAL Pudra	1
COL name VAL L'oreal paris FondÃ¶ten - True Match No:3.C/3.R Rose Beige 3600520457826 COL category VAL FondÃ¶ten	COL name VAL L'OrÃ©al Paris True Match BakÄ±m Yapan FondÃ¶ten 3D GOLDEN BEIGE COL category VAL Likit	1
COL name VAL L'oreal paris Brilliant Signature Plump In Gloss Ruj 410 I Inflate COL category VAL Dudak MakyajÄ±	COL name VAL L'orÃ©al Paris Brilliant Signature Plump In Gloss Ruj 410 I Inflate COL category VAL Rujlar	1
COL name VAL L'oreal paris True Match BakÄ±m Yapan FondÃ¶ten 2N VANILLA COL category VAL FondÃ¶ten	COL name VAL Loreal Paris True Match FondÃ¶ten 2n Vanilla COL category VAL Krem	0
COL name VAL Loreal Paris Mardinal L'oreal Paris Visible Lift Serum InsÄ±de Mat 120 COL category VAL Likit	COL name VAL L'oreal paris Visible Lift Serum InsÄ±de Mat 100 COL category VAL FondÃ¶ten	0
COL name VAL L'OrÃ©al Paris Infaillible Sculpt Palette KontÃ¼r Paleti 01 LIGHT MEDIUM COL category VAL Pudra	COL name VAL L'oreal paris KontÃ¼r Paleti - Infallible Sculpt Contouring Palette 03 Medium/Dark 3600523175093 COL category VAL Makyaj	1
COL name VAL L'oreal paris Mat Eyeliner - Matte Signature Eyeliner 05 Burgundy 30175266 COL category VAL GÃ¶z MakyajÄ±	COL name VAL Marka: L'oreal Paris Mat Eyeliner - Matte Signature Eyeliner 05 Burgundy 30175266 Kategori: Eyeline COL category VAL Eyeliner	0
COL name VAL Loreal Infallible Fresh Wear 24H FondÃ¶ten 60 Rose Ivory COL category VAL Likit	COL name VAL L'oreal paris Infaillible 32H Fresh Wear C Vitaminli FondÃ¶ten - 60 Rose Ivory COL category VAL FondÃ¶ten	1
COL name VAL L'oreal paris L'OrÃ©al Paris Infaillible 32H Fresh Wear C Vitaminli FondÃ¶ten - 220 Sand COL category VAL FondÃ¶ten	COL name VAL L'OrÃ©al Paris Infaillible 24H FondÃ¶ten - 220 Sand COL category VAL Loreal Paris FondÃ¶ten	1
COL name VAL L'oreal paris Mavi  Infaillible Gel Crayon Eyeliner 10 Blue 3600523351589 COL category VAL nan	COL name VAL L'Oreal Paris InfaÄ±llÄ±ble Gel Crayon 24h Eyeliner 10 Blue COL category VAL L"Oreal Paris Eyeliner	1
COL name VAL L'OrÃ©al Paris Infaillible Shaping Stick AydÄ±nlatÄ±cÄ± 502 Gold is cold COL category VAL AydÄ±nlatÄ±cÄ±lar	COL name VAL L'oreal paris Stick AydÄ±nlatÄ±cÄ± - Infaillible Shaping Stick 502 Gold is Cold 3600523533497 COL category VAL AydÄ±nlatÄ±cÄ±	1
COL name VAL L'OrÃ©al Paris Contour Khol GÃ¶z Kalemi 135 BROWN COL category VAL GÃ¶z Kalemi	COL name VAL L'oreal paris Kahverengi GÃ¶z Kalemi - Contour Kohl 135 Brown 3054080046950 COL category VAL GÃ¶z Kalemi	1
COL name VAL L'oreal paris Unbelieva Brow Uzun SÃ¼re KalÄ±cÄ± KaÅŸ Jeli -105 Brunette COL category VAL KaÅŸ Kalemi&KaÅŸ FarÄ±	COL name VAL Loreal Paris Lâ€™orÃ©al Paris Uzun SÃ¼re KalÄ±cÄ± KaÅŸ Jeli Unbelieva Brow - 109 Ebony COL category VAL KaÅŸ MakyajÄ±	0
COL name VAL L'OrÃ©al Paris Brow Artist High Contour 109 Ebony - Esmer COL category VAL KaÅŸ MakyajÄ±	COL name VAL L'oreal paris KaÅŸ Kalemi - Brow Artist High Contour 109 Ebony 3600523601691 COL category VAL KaÅŸ Kalemi&KaÅŸ FarÄ±	1
COL name VAL L'oreal paris L'OrÃ©al Paris Bambi Eye Ceylan GÃ¶z Etkili Maskara - Siyah COL category VAL Maskara	COL name VAL Loreal Paris L'orÃ©al Paris Bambi Eye Extra Black Ceylan GÃ¶z Etkili Maskara - Ekstra Siyah COL category VAL Maskara	0
COL name VAL Loreal Paris L'oreal Paris True Match BakÄ±m Yapan FondÃ¶ten 4n Beige COL category VAL Krem	COL name VAL L'oreal paris True Match BakÄ±m Yapan FondÃ¶ten 1n Ivory COL category VAL FondÃ¶ten	0
COL name VAL L'oreal paris Rouge Signature Likit Mat Ruj COL category VAL Dudak MakyajÄ±	COL name VAL L'OrÃ©al Paris Rouge Signature Likit Mat Ruj - 105 I Rule COL category VAL Rujlar	0
COL name VAL L'oreal paris True Match BakÄ±m Yapan FondÃ¶ten 8D GOLDEN CAPPUCCINO COL category VAL FondÃ¶ten	COL name VAL L'OrÃ©al Paris True Match BakÄ±m Yapan FondÃ¶ten 8D Golden CappuccÄ±no COL category VAL Likit	1
COL name VAL L'OrÃ©al Paris Color Riche Plump & Shine Ruj 104 Guava Plump COL category VAL Rujlar	COL name VAL L'oreal paris Ruj - Color Riche Plump And Shine Lipstick 104 Guava Plump 3600523687145 COL category VAL nan	1
COL name VAL L'OrÃ©al Paris Infaillible 24H Matte Cover YÃ¼ksek KapatÄ±cÄ± FondÃ¶ten - 200 Golden Sand COL category VAL Likit	COL name VAL L'oreal paris Infaillible 24h Matte Cover YÃ¼ksek KapatÄ±cÄ± FondÃ¶ten 115 Golden Beige COL category VAL FondÃ¶ten	0
COL name VAL L'oreal paris Likit Mat Ruj - Les Macarons Ultra Matte Liquid Lipstick 824 Guava Gush COL category VAL Dudak MakyajÄ±	COL name VAL L'OrÃ©al Paris Les Macarons Likit Mat Ruj 824 Guava Gush COL category VAL Rujlar	1
COL name VAL L'oreal paris Jel Siyah Eyeliner - Gel Intenza 24H Gel Eyeliner 01 Pure Black 3600522059448 COL category VAL GÃ¶z MakyajÄ±	COL name VAL L'OrÃ©al Paris Superliner Gel Intenza Siyah Eyeliner COL category VAL Eyeliner	1
COL name VAL L'OrÃ©al Paris Superliner Smokissime Eyeliner BLACK COL category VAL Eyeliner	COL name VAL L'oreal paris Siyah Smokissime Superliner 100 Black 3600522788911 COL category VAL nan	1
COL name VAL L'OrÃ©al Paris Paradise Suya DayanÄ±klÄ± Siyah Maskara COL category VAL Maskara	COL name VAL L'OrÃ©al Paris Paradise Suya DayanÄ±klÄ± Siyah Maskara COL category VAL Loreal Paris Maskara & Rimel	1
COL name VAL L'oreal paris Likit Mat Ruj - Les Chocolats Ultra Matte Liquid Lipstick 868 Cacao Rush 3600523643806 COL category VAL Dudak MakyajÄ±	COL name VAL L'Oreal Paris Les Chocolats Ultra Matte Likit Ruj 868 Cacao Crush COL category VAL L"Oreal Paris ParlatÄ±cÄ± & DolgunlaÅŸtÄ±rÄ±cÄ±	1
COL name VAL L'oreal paris Infaillible 24H Matte Cover YÃ¼ksek KapatÄ±cÄ± FondÃ¶ten 145 Rose Beige 3600523784424 COL category VAL FondÃ¶ten	COL name VAL L'OrÃ©al Paris Infaillible 24H Matte Cover YÃ¼ksek KapatÄ±cÄ± FondÃ¶ten - 145 Rose Beige COL category VAL Likit	1
COL name VAL L'oreal paris Likit Mat Ruj - Les Macarons Ultra Matte Liquid Lipstick 830 Blackcurrant Crush 360052 COL category VAL Dudak MakyajÄ±	COL name VAL L'Oreal Paris Les Macarons Ultra Matte Likit Ruj 830 Blackcurrant COL category VAL L"Oreal Paris ParlatÄ±cÄ± & DolgunlaÅŸtÄ±rÄ±cÄ±	1
COL name VAL L'OrÃ©al Paris Color Riche Ruj 134 PINK PANAC COL category VAL Rujlar	COL name VAL L'oreal paris Ruj - Color Riche Lipstick 134 Pink Panac 3600522851042 COL category VAL nan	1
COL name VAL Loreal Paris L'orÃ©al Paris Bambi Eye Extra Black Ceylan GÃ¶z Etkili Maskara - Ekstra Siyah COL category VAL Maskara	COL name VAL L'oreal paris Bambi Eye Extra Black Ceylan GÃ¶z Etkili Maskara Ekstra Siyah COL category VAL Maskara	0
COL name VAL L'OrÃ©al Paris True Match BakÄ±m Yapan FondÃ¶ten 1R ROSE IVORY COL category VAL Likit	COL name VAL L'oreal paris True Match BakÄ±m Yapan FondÃ¶ten 1N IVORY COL category VAL FondÃ¶ten	0
COL name VAL L'oreal paris L'OrÃ©al Paris Bambi Eye Ceylan GÃ¶z Etkili Maskara - Siyah COL category VAL Maskara	COL name VAL Loreal Paris L'oreal Paris Bambi Eye Ceylan GÃ¶z Etkili Maskara Eks. Siyah Maskara COL category VAL Maskara	0
COL name VAL L'OrÃ©al Paris Volume Million Lashes Carbon Black Maskara Siyah COL category VAL Maskara	COL name VAL L'oreal paris Siyah Maskara - Million Lashes Mascara Extra Black 3600521893500 COL category VAL Maskara	1
COL name VAL L'OrÃ©al Paris Color Riche Plump & Shine Ruj 102 Watermelon Plump COL category VAL Rujlar	COL name VAL L'oreal paris L'orÃ©al Paris Color Riche Plump & Shine Ruj COL category VAL Dudak MakyajÄ±	1
COL name VAL L'oreal paris Likit Mat Ruj - Les Macarons Ultra Matte Liquid Lipstick 828 Framboise Frenzy 3600523729043 COL category VAL Dudak MakyajÄ±	COL name VAL L'OrÃ©al Paris Les Macarons Likit Mat Ruj 828 Framboise Frenzy COL category VAL Rujlar	1
COL name VAL L'orÃ©al Paris Brilliant Signature Plump In Gloss Ruj 410 I Inflate COL category VAL Rujlar	COL name VAL L'oreal paris L'orÃ©al Paris Brilliant Signature Plump In Gloss Ruj 404 I Insert COL category VAL Dudak MakyajÄ±	0
COL name VAL L'oreal paris KaÅŸ Kalemi - Brow Artist High Contour 108 Warm Brown 3600523601684 COL category VAL KaÅŸ Kalemi&KaÅŸ FarÄ±	COL name VAL L'OrÃ©al Paris Brow Artist High Contour 105 Brunette â€“ Kumral COL category VAL KaÅŸ MakyajÄ±	1
COL name VAL L'oreal paris AÃ§Ä±k Kahverengi KaÅŸ Kalemi - Brow Artist Superliner 02 Blonde 3600522426806 COL category VAL nan	COL name VAL L'OrÃ©al Paris Brow Artist Shaper KaÅŸ Kalemi 02 Blonde COL category VAL KaÅŸ MakyajÄ±	1
COL name VAL L'oreal paris Mat Ruj - Color Riche Matte Addiction 908 Storm COL category VAL Dudak MakyajÄ±	COL name VAL L'OrÃ©al Paris Color Riche Matte Addiction Ruj 908 Storm - Gri/Lila COL category VAL Rujlar	1
COL name VAL L'oreal paris L'OrÃ©al Paris Infaillible TÃ¼m YÃ¼ze Uygulanabilir KapatÄ±cÄ± 332 Amber COL category VAL nan	COL name VAL L'OrÃ©al Paris Infaillible TÃ¼m YÃ¼ze Uygulanabilir KapatÄ±cÄ± 332 Amber COL category VAL Kozmetik KiÅŸisel BakÄ±m	1
COL name VAL L'OrÃ©al Paris Micellar Kusursuz Makyaj Temizleme Suyu Normal 400ML COL category VAL Makyaj Temizleme ÃœrÃ¼nleri	COL name VAL L'oreal paris Micellar Kusursuz  Normal 400ml Makyaj Temizleme Suyu 60052332994 COL category VAL Makyaj Temizleyici	0
COL name VAL Loreal Paris L'oreal Paris Paradise Maskara Siyah Maskara COL category VAL Maskara	COL name VAL L'oreal paris Paradise Extatic Siyah Maskara COL category VAL Maskara	0
COL name VAL L'oreal paris Dudak Kalemi - Infaillible Lip Pencil 701 Stay Ultraviolet COL category VAL Dudak MakyajÄ±	COL name VAL L'OrÃ©al Paris Infallible Stay Ultraviolet 701 Dudak Kalemi COL category VAL Dudak Kalemleri	0
COL name VAL L'oreal paris Stick FondÃ¶ten Infaillible Shaping Stick FondÃ¶ten 140 Natural Rose 3600523531479 COL category VAL nan	COL name VAL L'OrÃ©al Paris Infaillible Shaping Stick FondÃ¶ten 140 Natural Rose COL category VAL Likit	1
COL name VAL Loreal expert L'orÃ©al Paris Mega Volume Collagene 24h Siyah Maskara COL category VAL Maskara	COL name VAL Loreal Paris L'orÃ©al Paris Mega Volume Collagene 24H Siyah Maskara COL category VAL Maskara	1
COL name VAL Marka: L'oreal Paris Mat Eyeliner - Matte Signature Eyeliner 05 Burgundy 30175266 Kategori: Eyeline COL category VAL Eyeliner	COL name VAL L'oreal paris Mat Eyeliner - Matte Signature Eyeliner 05 Burgundy 30175266 COL category VAL GÃ¶z MakyajÄ±	0
COL name VAL L'oreal paris Siyah Bambi Eye Oversized Ceylan GÃ¶z Etkili Maskara COL category VAL Maskara	COL name VAL Loreal Paris Bambi Eye Ceylan GÃ¶z Etkili Maskara - Siyah X2 COL category VAL Maskara	0
COL name VAL L'oreal paris Likit Mat Ruj - Infallible Lip Paint Matte 203 Tangerine Vertigo 3600523348015 COL category VAL Dudak MakyajÄ±	COL name VAL L'OrÃ©al Paris Infaillible Lip Paint Likit Ruj Matte 203 Tangerine Vertigo COL category VAL Rujlar	1
COL name VAL L'oreal paris Infaillible 24h Fresh Wear Pudra FondÃ¶ten 40 Cashmere COL category VAL Makyaj	COL name VAL Loreal Infaillible 24H Fresh Wear Pudra FondÃ¶ten 40 Cashmere COL category VAL Pudra	1
COL name VAL L'OrÃ©al Paris Glam Shine Balmy Gloss- 915 COL category VAL Rujlar	COL name VAL L'Oreal Paris Kalem Ruj No: 915 COL category VAL L"Oreal Paris Ruj	1
COL name VAL L'oreal paris Loreal Color Queen Tekli GÃ¶z FarÄ± 20 Queen COL category VAL GÃ¶z FarÄ±	COL name VAL L'OrÃ©al Paris Color Queen Tekli GÃ¶z FarÄ± 20 Queen COL category VAL GÃ¶z FarÄ±	1
COL name VAL Loreal Paris Bambi Eye Ceylan GÃ¶z Etkili Maskara Siyah x 2 COL category VAL Maskara	COL name VAL L'oreal paris L'orÃ©al Paris Bambi Eye Oversized Ceylan GÃ¶z Etkili Maskara - Siyah COL category VAL Maskara	0
COL name VAL L'oreal paris Siyah Eyeliner - Infallible Eye Stylo Eyeliner 16H 301 Night Day Black 3600521663523 COL category VAL nan	COL name VAL L'OrÃ©al Paris Infaillible 24H GÃ¶z Kalemi 301 NIGHT DAY BLACK COL category VAL GÃ¶zler	1
COL name VAL L'oreal paris Suya DayanÄ±klÄ± Siyah Eyeliner - Super Liner Black Lacquer Waterproof Eyeliner 6 ml 3600522025252 COL category VAL nan	COL name VAL L'OrÃ©al Paris Superliner Black Lacquer Waterproof Eyeliner - Siyah COL category VAL Eyeliner	1
COL name VAL Loreal Paris HÄ±ghlÄ±ghter Glow Mon Amour 05 Glow De Coco COL category VAL AydÄ±nlatÄ±cÄ±lar	COL name VAL L'oreal paris Glow Mon Amour 05 Glow De Coco Likit AydÄ±nlatÄ±cÄ±  Highlighter 15 ml COL category VAL AydÄ±nlatÄ±cÄ±	1
COL name VAL L'OrÃ©al Paris True Match BakÄ±m Yapan FondÃ¶ten 1R ROSE IVORY COL category VAL Likit	COL name VAL L'oreal paris L'orÃ©al Paris True Match BakÄ±m Yapan FondÃ¶ten 1r Rose Ivory & True Match KapatÄ±cÄ± 1n Ivory COL category VAL FondÃ¶ten	0
COL name VAL L'OrÃ©al Paris True Match FondÃ¶ten W7/D7 Golden Amber COL category VAL Likit	COL name VAL L'oreal paris FondÃ¶ten - True Match Fondoten No:7.D/7.W Golden Amber 3600520457895 COL category VAL FondÃ¶ten	1
COL name VAL L'oreal paris Mat Ruj - Color Riche Matte Addiction Lipstick 634 Geige Hype 3600523399802 COL category VAL Ruj	COL name VAL L'OrÃ©al Paris Color Riche Matte Addiction Ruj 634 Greige Perfecto - Kahverengi COL category VAL Rujlar	1
COL name VAL L'oreal paris Telescopic Carbon Extra Black Maskara - Siyah COL category VAL Maskara	COL name VAL L'OrÃ©al Paris Telescopic Carbon Black Maskara - Siyah COL category VAL Maskara	1
COL name VAL L'oreal paris Color Riche X Balmain Ruj 356 Confidence- Nude COL category VAL Ruj	COL name VAL L'OrÃ©al Paris Color Riche x Balmain Collection Couture Woman Mat Ruj 356 Confidence COL category VAL Dudaklar	1
COL name VAL L'oreal paris Ruj - Lip Paint Metallic 305 Cute But 3600523518272 COL category VAL Dudak MakyajÄ±	COL name VAL L'OrÃ©al Paris Infaillible Metallic Lip Paint 305 Cute But Psycho COL category VAL Rujlar	1
COL name VAL L'OrÃ©al Paris Rouge Signature Metallic Likit Ruj - 204 I Voodoo COL category VAL Rujlar	COL name VAL L'oreal paris Likit Metalik Ruj - Rouge Signature Metallic 204 I Voodoo 3600523689576 COL category VAL Dudak MakyajÄ±	1
COL name VAL L'oreal paris Bb Krem - Bonjour Nudista Bb Cream 04 Medium Dark 3600523560615 COL category VAL Makyaj	COL name VAL L'Oreal Paris BB Krem - Bonjour Nudista BB Cream 04 Medium Dark COL category VAL Loreal Paris KapatÄ±cÄ±	1
COL name VAL L'Oreal Paris Emotions Of Nu AllÄ±k Far Paleti Sky Maskara Seti COL category VAL L"Oreal Paris GÃ¶z FarÄ±	COL name VAL L'oreal paris Emotions Of Nu AllÄ±k Far Paleti Sky Maskara Seti COL category VAL GÃ¶z FarÄ±	1
COL name VAL L'oreal paris True Match BakÄ±m Yapan FondÃ¶ten 5.5D GOLDEN SUN COL category VAL FondÃ¶ten	COL name VAL L'OrÃ©al Paris True Match BakÄ±m Yapan FondÃ¶ten 5.5D Golden Sun COL category VAL Likit	1
COL name VAL L'OrÃ©al Paris Infaillible 24H Matte FondÃ¶ten 30 MIEL HONEY COL category VAL Likit	COL name VAL L'oreal paris Infaillible 24h Matte 30 Honey 35 ml Mat FondÃ¶ten -3600522875413 COL category VAL nan	1
COL name VAL L'OrÃ©al Paris Infaillible TÃ¼m YÃ¼ze Uygulanabilir KapatÄ±cÄ± 323 Fawn COL category VAL KapatÄ±cÄ±lar	COL name VAL L'oreal paris TÃ¼m YÃ¼ze Uygulanabilir KapatÄ±cÄ± - Infaillible More Than Concealer 323 Fawn COL category VAL Makyaj	1
COL name VAL L'Oreal Paris Color Richa Ultra Matte Mat Ruj No Doubts COL category VAL L"Oreal Paris Ruj	COL name VAL L'OrÃ©al Paris Color Riche Free The Nudes Ruj - No Doubts COL category VAL Rujlar	1
COL name VAL L'Oreal Paris Ruj Lip Paint Metallic 306 Lolita COL category VAL L"Oreal Paris Ruj	COL name VAL L'oreal paris Ruj - Lip Paint Metallic 306 Lolita 3600523518289 COL category VAL nan	1
COL name VAL L'orÃ©al Paris Color Riche Saten BitiÅŸli Ruj 143 Pink Pigalle - Pembe COL category VAL Rujlar	COL name VAL L'oreal paris L'orÃ©al Paris Color Riche Saten BitiÅŸli Ruj 143 Pink Pigalle - Pembe COL category VAL Dudak MakyajÄ±	0
COL name VAL L'oreal paris Kahverengi Power Color Riche Rock Woman Mat Ruj 650 COL category VAL Dudak MakyajÄ±	COL name VAL L'OrÃ©al Paris Color Riche x Balmain Collection Rock Woman Mat Ruj 650 Power COL category VAL Rujlar	1
COL name VAL L'oreal paris Stick FondÃ¶ten - Infaillible Longwear Shaping Stick Foundation 210 Capuccino 9 g 3600523531547 COL category VAL FondÃ¶ten	COL name VAL L'OrÃ©al Paris Infaillible Shaping Stick FondÃ¶ten 210 Capuccino COL category VAL Krem	1
COL name VAL L'Oreal Paris True Match BakÄ±m Yapan FondÃ¶ten 5D Golden Sand COL category VAL L"Oreal Paris FondÃ¶ten	COL name VAL L'oreal paris L'orÃ©al Paris True Match BakÄ±m Yapan FondÃ¶ten 5d Golden Sand COL category VAL FondÃ¶ten	1
COL name VAL L'oreal paris Color Riche Shine Naked Tans Ruj 658 Topless - Nude COL category VAL nan	COL name VAL L'OrÃ©al Paris Color Riche Shine Naked Tans Ruj 658 Topless - Nude COL category VAL Dudaklar	1
COL name VAL L'OrÃ©al Paris True Match Nude FondÃ¶ten Serum 3-4 Light Medium COL category VAL Likit	COL name VAL L'oreal paris L'orÃ©al Paris True Match Nude FondÃ¶ten Serum 3-4 Light Medium COL category VAL FondÃ¶ten	1
COL name VAL Loreal Paris Loreal Color Riche Lipstick 125 COL category VAL Rujlar	COL name VAL Lâ€™oreal Paris Color Riche Ruj No:125 Maison Marais 3600523802005 COL category VAL Loreal Paris Ruj	1
COL name VAL L'oreal paris Riche Matte Addiction Ruj 471 Voodoo COL category VAL Dudak MakyajÄ±	COL name VAL L'OrÃ©al Paris Color Riche Matte Addiction Ruj 471 Voodoo - Mor COL category VAL Rujlar	1
COL name VAL L'oreal paris L'orÃ©al Paris Unbelieva Brow Uzun SÃ¼re KalÄ±cÄ± KaÅŸ Jeli - 109 Ebony COL category VAL GÃ¶z MakyajÄ±	COL name VAL Loreal Paris Lâ€™orÃ©al Paris Uzun SÃ¼re KalÄ±cÄ± KaÅŸ Jeli Unbelieva Brow - 109 Ebony COL category VAL KaÅŸ MakyajÄ±	1
COL name VAL L'orÃ©al Paris True Match BakÄ±m Yapan FondÃ¶ten 1r Rose Ivory, 30 ml COL category VAL Krem	COL name VAL L'oreal paris True Match BakÄ±m Yapan FondÃ¶ten 1N IVORY COL category VAL FondÃ¶ten	0
COL name VAL L'orÃ©al Paris Bambi Eye Oversized Ceylan GÃ¶z Etkili Maskara - Siyah COL category VAL Maskara	COL name VAL L'oreal paris Siyah Bambi Eye Oversized Ceylan GÃ¶z Etkili Maskara COL category VAL Maskara	1
COL name VAL L'oreal paris Infaillible 24h Fresh Wear Pudra FondÃ¶ten 220 Sand COL category VAL Makyaj	COL name VAL L'OrÃ©al Paris Infaillible 24H Fresh Wear Pudra FondÃ¶ten 220 Sand COL category VAL Pudra	1
COL name VAL L'OrÃ©al Paris True Match BakÄ±m Yapan FondÃ¶ten 3R ROSE BEIGE COL category VAL Likit	COL name VAL L'oreal paris True Match BakÄ±m Yapan FondÃ¶ten 3R ROSE BEIGE COL category VAL FondÃ¶ten	0
COL name VAL L'OrÃ©al Paris Infaillible TÃ¼m YÃ¼ze Uygulanabilir KapatÄ±cÄ± 323 Fawn COL category VAL KapatÄ±cÄ±lar	COL name VAL L'oreal paris L'OrÃ©al Paris Infaillible 24H TÃ¼m YÃ¼ze Uygulanabilir KapatÄ±cÄ± - 330 Pecan COL category VAL Makyaj	0
COL name VAL L'OrÃ©al Paris Bronze Please! BronzlaÅŸtÄ±rÄ±cÄ± Pudra 03 Amalfi Medio COL category VAL AllÄ±klar	COL name VAL L'Oreal Paris Bronze BronzlaÅŸtÄ±rÄ±cÄ± Pudra Amalfi Medio 03 COL category VAL L"Oreal Paris Pudra	1
COL name VAL L'OrÃ©al Paris Color Riche Plump & Shine Ruj 109 Blue Mint Plump COL category VAL Rujlar	COL name VAL L'oreal paris Color Riche Plump & Shine Ruj 109 Blue Mint Plump 3600523700455 COL category VAL Dudak MakyajÄ±	1
COL name VAL L'oreal paris Bambi Eye Ceylan GÃ¶z Etkili Siyah Maskara 30175792 COL category VAL Maskara	COL name VAL L'OrÃ©al Paris Bambi Eye Ceylan GÃ¶z Etkili Maskara - Siyah COL category VAL Maskara	0
COL name VAL L'OrÃ©al Paris Merry Metals Superliner 03 Gold COL category VAL Eyeliner	COL name VAL L'oreal paris Merry Metals Superliner 03 Gold Eyeliner -3600523515752 COL category VAL nan	1
COL name VAL L'OrÃ©al Paris Color Riche x Balmain Collection Couture Woman Mat Ruj 356 Confidence COL category VAL Dudaklar	COL name VAL L'oreal paris Color Riche X Balmain Ruj 356 Confidence- Nude COL category VAL Ruj	1
COL name VAL L'oreal paris C'Ã©st Magic BB Krem 02 Light 3600523723539 COL category VAL BB ve CC Krem	COL name VAL L'OrÃ©al Paris C'Ã‰st Magic Bb Krem 02 Light COL category VAL BB Kremler	1
COL name VAL L'oreal paris L'OrÃ©al Paris Bronze to Paradise Mat BronzlaÅŸtÄ±rÄ±cÄ± Pudra 02 Baby One More Tan COL category VAL Makyaj	COL name VAL Loreal Paris Bronze To Paradise BronzlaÅŸtÄ±rÄ±cÄ± Pudra 02 Baby One More Tan COL category VAL Pudra	1
COL name VAL Loreal Paris L'orÃ©al Paris Lash Paradise Intense Black Ekstra Siyah Maskara 2'li Set 1 Paket (1 x 2 Adet COL category VAL Maskara	COL name VAL L'oreal paris Lash Paradise Intense Black Ekstra Siyah Maskara COL category VAL Maskara	0
COL name VAL L'oreal paris Color Queen GÃ¶z Far 21 COL category VAL GÃ¶z FarÄ±	COL name VAL L'OrÃ©al Paris Color Queen Tekli GÃ¶z FarÄ± 21 Almighty COL category VAL GÃ¶z FarÄ±	1
COL name VAL L'OrÃ©al Paris Bambi Eye Ceylan GÃ¶z Etkili Maskara - Siyah COL category VAL Maskara	COL name VAL L'oreal paris Bambi Eye False Lash Ceylan GÃ¶z Etkili Ekstra Siyah Maskara COL category VAL Maskara	0
COL name VAL L'OrÃ©al Paris Matte Signature Eyeliner 05 Burgundy - Bordo COL category VAL Eyeliner	COL name VAL L'oreal paris Mat Eyeliner - Matte Signature Eyeliner 05 Burgundy 30175266 COL category VAL nan	1
COL name VAL L'OrÃ©al Paris True Match Nude FondÃ¶ten Serum 2-3 Light COL category VAL Likit	COL name VAL L'oreal paris L'orÃ©al Paris True Match Nude FondÃ¶ten Serum 0.5-2 Very Light COL category VAL FondÃ¶ten	0
COL name VAL L'oreal paris Color Riche Les Nus Ruj 179 Nu Decadent COL category VAL Dudak MakyajÄ±	COL name VAL L'Oreal Paris Color Riche Les Nus Ruj 179 Decadent COL category VAL L"Oreal Paris Ruj	1
COL name VAL L'OrÃ©al Paris Color Riche Shine Ruj 111 Instaheaven - Pembe COL category VAL Rujlar	COL name VAL L'oreal paris Ruj - Color Riche Shine Addiction Lipstick 111 Instaheaven 3600523465255 COL category VAL Dudak MakyajÄ±	1
COL name VAL L'oreal paris GÃ¶z FarÄ± - Infaillible Eyeshadow Paint 101 Eternal White 3600523240937 COL category VAL nan	COL name VAL L'OrÃ©al Paris Infaillible Eye Paint GÃ¶z FarÄ± 101 Eternal White COL category VAL GÃ¶z FarÄ±	1
COL name VAL L'OrÃ©al Paris Bambi Eye Ceylan GÃ¶z Etkili Maskara - Siyah COL category VAL Maskara	COL name VAL L'oreal paris L'orÃ©al Paris Bambi Eye Oversized Ceylan GÃ¶z Etkili Maskara - Siyah COL category VAL Maskara	0
COL name VAL L'oreal paris GÃ¶z FarÄ± - Infaillible Eyeshadow Paint 202 Keep On Khaki 3600523240869 COL category VAL GÃ¶z FarÄ±	COL name VAL L'OrÃ©al Paris Infaillible Eye Paint GÃ¶z FarÄ± 202 Keep on Khaki COL category VAL GÃ¶z FarÄ±	1
COL name VAL L'OrÃ©al Paris Les Macarons Likit Mat Ruj 822 Mon Caramel COL category VAL Rujlar	COL name VAL L'oreal paris Likit Mat Ruj - Les Macarons Ultra Matte Liquid Lipstick 822 Mon Caramel 3600523729081 COL category VAL Dudak MakyajÄ±	1
COL name VAL Loreal Paris L'oreal Paris Telescopic Carbon Black Maskara - Siyah & Infaillible 24H Fresh Wear Pudra FondÃ¶ten 120 Vanilla COL category VAL Maskara	COL name VAL L'oreal paris Telescopic Carbon Black Maskara - Siyah & Infaillible 24h Fresh Wear Pudra FondÃ¶ten 40 Cashmere COL category VAL Makyaj	0
COL name VAL Loreal Paris True Match FondÃ¶ten 1r Rose Ivory 30ML COL category VAL Likit	COL name VAL L'oreal paris True Match FondÃ¶ten 1r1c1k Ivory Rose COL category VAL FondÃ¶ten	0
COL name VAL L'oreal paris L'orÃ©al Paris True Match Nude FondÃ¶ten Serum 0.5-2 Very Light COL category VAL FondÃ¶ten	COL name VAL L'OrÃ©al Paris True Match Nude FondÃ¶ten Serum 0.5-2 Very Light COL category VAL Likit	1
COL name VAL Loreal Paris Telescopic Maskara GÃ¶z Makyaj Seti COL category VAL Maskara	COL name VAL L'oreal paris Loreal Telescopic Maskara GÃ¶z Makyaj Seti COL category VAL Maskara	0
COL name VAL L'oreal paris KaÅŸ Kalemi - Brow Artist Xpert 109 Ebony 3600523352876 COL category VAL nan	COL name VAL L'OrÃ©al Paris Brow Artist Xpert No 109 Ebony COL category VAL KaÅŸ MakyajÄ±	1
COL name VAL L'oreal paris Eye Go Wild GÃ¶z FarÄ± Paleti 3600523815449 COL category VAL GÃ¶z FarÄ±	COL name VAL L'OrÃ©al Paris Eye Go Wild Paleti COL category VAL GÃ¶z FarÄ±	1
COL name VAL L'oreal paris Ruj - Color Riche Shine Addiction Lipstick 352 YOLO 3600523465309 COL category VAL Dudak MakyajÄ±	COL name VAL L'OrÃ©al Paris Color Riche Shine Ruj 352 Y.O.L.O - KÄ±rmÄ±zÄ± COL category VAL Rujlar	1
COL name VAL L'oreal paris Ruj - Color Riche Free The Nudes 03 No Doubts COL category VAL Dudak MakyajÄ±	COL name VAL L'oreal Paris Color Riche Free The Nudes Ruj - No Pressure COL category VAL Rujlar	0
COL name VAL L'oreal paris Ruj - Color Riche Free The Nudes 06 No Hesitation 3600523747153 COL category VAL Dudak MakyajÄ±	COL name VAL L'Oreal Paris Color Richa Ultra Matte Mat Ruj No: 6 Hesitation COL category VAL L"Oreal Paris Ruj	1
COL name VAL L'OrÃ©al Paris Les Macarons Likit Mat Ruj 826 Mademoiselle Mango COL category VAL Rujlar	COL name VAL L'oreal paris Likit Mat Ruj - Les Macarons Ultra Matte Liquid Lipstick 826 Mademoiselle Mango 3600523729098 COL category VAL nan	1
COL name VAL L'oreal paris L'orÃ©al Paris Lash Paradise Siyah Maskara COL category VAL Maskara	COL name VAL Loreal Paris L'orÃ©al Paris Paradise Siyah Maskara, 6.4 ml COL category VAL Maskara	0
COL name VAL Loreal Paris Loreal Matte Lip Crayon Mat Kalem Ruj No 108 COL category VAL Rujlar	COL name VAL L'oreal paris Infaillible Matte Lip Crayon Kalem Mat Ruj - 108 Hot Apricot COL category VAL Dudak MakyajÄ±	1
COL name VAL L'oreal paris True Match BakÄ±m Yapan FondÃ¶ten 1N IVORY COL category VAL FondÃ¶ten	COL name VAL L'oreal Paris True Match BakÄ±m Yapan FondÃ¶ten 5n Sand FondÃ¶ten COL category VAL Krem	0
COL name VAL L'oreal paris Infaillible Resurfacing GÃ¶zenek Gizleyici ve PÃ¼rÃ¼zsÃ¼zleÅŸtirici Makyaj BazÄ± COL category VAL Makyaj BazÄ±	COL name VAL Loreal Paris L'orÃ©al Paris Infaillible Resurfacing GÃ¶zenek Gizleyici ve PÃ¼rÃ¼zsÃ¼zleÅŸtirici Makyaj BazÄ± Ka COL category VAL Makyaj BazlarÄ±	0
COL name VAL L'OrÃ©al Paris Color Riche Shine Naked Tans Ruj 247 Shot Of Sun - Nude COL category VAL Rujlar	COL name VAL L'oreal paris Ruj - Color Riche Shine Naked Tans 247 Shot Of Sun - Nude 3600523597758 COL category VAL nan	1
COL name VAL L'orÃ©al Paris Color Queen Tekli GÃ¶z FarÄ± 30 Sky-High COL category VAL GÃ¶z FarÄ±	COL name VAL L'oreal paris Tekli GÃ¶z FarÄ± - Color Queen Mono Eyeshadow 30 Sky-High 30173286 COL category VAL GÃ¶z FarÄ±	1
COL name VAL L'OrÃ©al Paris Woke Up Like This AydÄ±nlatÄ±cÄ± Palet - La Vie En Glow Warm Glow COL category VAL AydÄ±nlatÄ±cÄ±lar	COL name VAL L'oreal paris La Vie En Glow AydÄ±nlatÄ±cÄ± Paleti Cool Glow - SÄ±cak Tonlar COL category VAL nan	1
COL name VAL L'oreal paris Color Queen Tekli GÃ¶z FarÄ± 21 Almighty TXBA00FD85694 COL category VAL GÃ¶z FarÄ±	COL name VAL L'OrÃ©al Paris Color Queen Tekli GÃ¶z FarÄ± 21 Almighty COL category VAL GÃ¶z FarÄ±	0
COL name VAL L'oreal paris L'orÃ©al Paris True Match BakÄ±m Yapan FondÃ¶ten 5d Golden Sand COL category VAL FondÃ¶ten	COL name VAL L'OrÃ©al Paris True Match BakÄ±m Yapan FondÃ¶ten - 5D Golden Sand COL category VAL Loreal Paris FondÃ¶ten	1
COL name VAL L'OrÃ©al Paris Infaillible 24H FondÃ¶ten - 200 Golden Sand COL category VAL Loreal Paris FondÃ¶ten	COL name VAL L'OrÃ©al Paris Infaillible 24H FondÃ¶ten 200 GOLDEN SAND COL category VAL Krem	1
COL name VAL Loreal Paris Volume Million Lashes Carbon Black Maskara - Siyah COL category VAL Maskara	COL name VAL L'oreal paris Siyah Maskara - Volume Million Lashes Feline Mascara Black COL category VAL nan	0
COL name VAL L'Oreal Paris Paradise Maskara 2'li Matara Hediyeli COL category VAL Loreal Paris Maskara & Rimel	COL name VAL L'oreal paris Paradise Maskara 2'li Matara Hediyeli COL category VAL Maskara	1
COL name VAL L'OrÃ©al Paris Superliner Black Velvet Eyeliner COL category VAL Eyeliner	COL name VAL L'oreal paris Siyah Eyeliner - Infallible Superliner Black velvet 3600523169948 COL category VAL GÃ¶z MakyajÄ±	1
COL name VAL L'oreal paris Ä°nfaillible Eye Liner 306 Stay Blue COL category VAL nan	COL name VAL L'OrÃ©al Paris Ä°nfaillible Eye Liner 306 Stay Blue COL category VAL GÃ¶z Kalemi	1
COL name VAL L'oreal paris Emotions Of Nu AllÄ±k Far Paleti Sky Maskara Seti COL category VAL GÃ¶z FarÄ±	COL name VAL L'Oreal Paris Emotions Of Nu AllÄ±k Far Paleti Sky Maskara Seti COL category VAL L"Oreal Paris GÃ¶z FarÄ±	1
COL name VAL L'oreal paris Bb Krem - Bonjour Nudista Bb Cream 04 Medium Dark 3600523560615 COL category VAL Makyaj	COL name VAL L'OrÃ©al Paris Bonjour Nudista AydÄ±nlÄ±k Veren Renkli Nemlendirici 04 Medium Dark - Koyu Ton COL category VAL Krem	1
COL name VAL L'OrÃ©al Paris True Match Nude FondÃ¶ten Serum 2-3 Light COL category VAL Likit	COL name VAL L'oreal paris L'orÃ©al Paris True Match Nude FondÃ¶ten Serum 2-3 Light COL category VAL FondÃ¶ten	1
COL name VAL L'oreal paris Accord Parfait Pdre Fr 6.5.d/6.5w C COL category VAL Makyaj	COL name VAL L'OrÃ©al Paris True Match Pudra W1 GOLDEN IVORY COL category VAL Pudra	1
COL name VAL L'OrÃ©al Paris Infaillible 24H Matte Cover YÃ¼ksek KapatÄ±cÄ± FondÃ¶ten - 25 Rose Ivory COL category VAL Likit	COL name VAL L'oreal paris Infaillible 24H Matte Cover YÃ¼ksek KapatÄ±cÄ± FondÃ¶ten 25 Rose Ivory 3600523784394 COL category VAL FondÃ¶ten	1
COL name VAL L'OrÃ©al Paris Infaillible Metallic Eye Paint 401 Metallic Copper COL category VAL GÃ¶z FarÄ±	COL name VAL L'oreal paris GÃ¶z FarÄ± - Infallible Paint Eyeshadow 401 Metal Copp 3600523515653 COL category VAL GÃ¶z FarÄ±	1
COL name VAL L'OrÃ©al Paris Color Riche Ruj Matte 330 Cocorico COL category VAL Rujlar	COL name VAL L'oreal paris Ruj - Color Riche Lipstick 330 Cocorico 3600522857327 COL category VAL Dudak MakyajÄ±	1
COL name VAL L'oreal paris Blush Cherie On The Cake & Bronzer 02 Dark Chocolate AllÄ±k & BronzlaÅŸtÄ±rÄ±cÄ± Pudra - 3600523706778 COL category VAL nan	COL name VAL L'orÃ©al Paris Cherie On The Cake AllÄ±k ve BronzlaÅŸtÄ±rÄ±cÄ± Pudra - 02 Dark Chocolate COL category VAL AllÄ±klar	1
COL name VAL Loreal Paris True Match FondÃ¶ten 2N Vanilla COL category VAL Loreal Paris FondÃ¶ten	COL name VAL Loreal Paris True Match FondÃ¶ten 2n Vanilla COL category VAL Krem	1
COL name VAL L'OrÃ©al Paris Color Riche Shine Naked Tans Ruj 656 Beige In The City - Nude COL category VAL Rujlar	COL name VAL L'oreal paris L'orÃ©al Paris Color Riche Shine Naked Tans Ruj 656 Beige In The City - Nude COL category VAL nan	1
COL name VAL L'oreal paris Infaillible 24h Fresh Wear Pudra FondÃ¶ten 140 Golden Beige COL category VAL Makyaj	COL name VAL Infaillible 24H Fresh Wear Pudra FondÃ¶ten 140 Golden Beige COL category VAL Pudra	1
COL name VAL L'oreal paris Paris Waterproof Crayon Eyeliner 06 Golden COL category VAL Dudak MakyajÄ±	COL name VAL Loreal Paris Waterproof Crayon Eyeliner 07 Silver+06 Gold COL category VAL GÃ¶z Kalemi	0
COL name VAL L'oreal Paris True Match BakÄ±m Yapan FondÃ¶ten 5n Sand FondÃ¶ten COL category VAL Krem	COL name VAL L'oreal paris True Match BakÄ±m Yapan FondÃ¶ten 2r Rose COL category VAL FondÃ¶ten	0
COL name VAL L'oreal Paris True Match BakÄ±m Yapan FondÃ¶ten 1n Ivory FondÃ¶ten COL category VAL Krem	COL name VAL L'oreal paris L'orÃ©al Paris True Match BakÄ±m Yapan FondÃ¶ten 1n Ivory COL category VAL FondÃ¶ten	1
COL name VAL L'oreal paris Infaillible 24h Matte Cover 290 Ambre Dore/golden Amber FondÃ¶ten 30ml COL category VAL FondÃ¶ten	COL name VAL Loreal Paris Infaillible 24H Matte Cover FondÃ¶ten 115 Beige Dore/golden Beige 30ML COL category VAL Likit	0
COL name VAL L'OrÃ©al Paris Rouge Caresse - Ruj 03 Lovely Rose COL category VAL Rujlar	COL name VAL L'oreal paris Ruj - Labial Color Riche Caresse Lipstick 03 Lovely Rose 3600522110347 COL category VAL nan	1
COL name VAL Loreal Infallible Longwear Shaping Stick 503 COL category VAL Krem	COL name VAL Loreal botanicals Loreal Infallible Longwear Shaping Stick 501 COL category VAL FondÃ¶ten	0
COL name VAL L'oreal paris L'orÃ©al Paris Superliner Gel Intenza Siyah Eyeliner COL category VAL Eyeliner	COL name VAL Loreal Paris L'orÃ©al Paris Superliner Gel Intenza Siyah Eyeliner COL category VAL Eyeliner	1
COL name VAL L'oreal Paris True Match BakÄ±m Yapan FondÃ¶ten 1n Ivory FondÃ¶ten COL category VAL Krem	COL name VAL L'oreal paris True Match BakÄ±m Yapan FondÃ¶ten 4n BeÄ±ge COL category VAL FondÃ¶ten	0
COL name VAL L'oreal paris Super Liner Gelmatic 02 Deep Violet - Mor GÃ¶z Kalemi COL category VAL GÃ¶z Kalemi	COL name VAL L'OrÃ©al Paris Superliner Gel Matic 01 COL category VAL Eyeliner	1
COL name VAL Loreal Paris L'oreal Paris Chroma Neon Liner 21 Electric Zoo Eyeliner COL category VAL Eyeliner	COL name VAL L'oreal paris Chroma Neon LÄ±ner 21 Electric Zoo COL category VAL nan	1
COL name VAL L'oreal paris Likit Metalik Ruj - Rouge Signature Metallic 202 I Electrify 3600523689552 COL category VAL Dudak MakyajÄ±	COL name VAL L'OrÃ©al Paris Rouge Signature Metallic Likit Ruj - 202 I Electrify COL category VAL Rujlar	1